Cell_ID	Cluster_ID
AAACCTGAGACCGGAT	PL-2
AAACCTGAGATGTTAG	PL-1
AAACCTGAGCCCTAAT	PL-1
AAACCTGAGCGCCTCA	PL-1
AAACCTGAGGATATAC	PL-1
AAACCTGCAATGAATG	PL-2
AAACCTGCAATTCCTT	PL-robo2
AAACCTGCACGAAGCA	PL-0
AAACCTGCACTTAACG	PL-2
AAACCTGCAGCGATCC	PL-3
AAACCTGCAGCGTAAG	PL-Inos
AAACCTGCATCGGGTC	PL-Rel
AAACCTGGTACTCGCG	PL-robo2
AAACCTGGTAGCTCCG	PL-0
AAACCTGGTTCCCGAG	PL-0
AAACCTGTCAAACCGT	PL-Rel
AAACCTGTCCGTTGTC	PL-0
AAACCTGTCCTAGAAC	PL-0
AAACGGGCAAAGGCGT	PL-0
AAACGGGCAAGACACG	PL-3
AAACGGGCAAGCGCTC	PL-0
AAACGGGCACAGACAG	PL-Rel
AAACGGGCATTCTCAT	PL-2
AAACGGGGTATAAACG	PL-Lsp
AAACGGGGTCTCTTAT	PL-3
AAACGGGGTCTTGTCC	PL-1
AAACGGGGTGGAAAGA	PL-2
AAACGGGGTTCCCTTG	PL-AMP
AAACGGGGTTCCGTCT	PL-1
AAACGGGTCCATGCTC	PL-2
AAACGGGTCCCAAGTA	PL-2
AAACGGGTCCCTAATT	PL-1
AAACGGGTCGTCACGG	PL-Rel
AAACGGGTCTGATTCT	PL-robo2
AAACGGGTCTGCCAGG	PL-3
AAAGATGAGAAACCTA	PL-vir1
AAAGATGAGAGTAAGG	PL-1
AAAGATGAGCAACGGT	PL-0
AAAGATGAGCTGAACG	PL-0
AAAGATGAGGCCCGTT	PL-2
AAAGATGAGTCGTTTG	PL-2
AAAGATGCAAACTGTC	PL-1
AAAGATGCACCATGTA	PL-0
AAAGATGGTCACACGC	PL-Rel
AAAGATGGTCACTTCC	PL-1
AAAGATGGTGACGCCT	PL-0
AAAGATGGTTCAACCA	PL-Rel
AAAGATGGTTCGCTAA	PL-2
AAAGATGGTTGTGGCC	PL-2
AAAGATGTCAAGGCTT	PL-1
AAAGATGTCACTTACT	PL-2
AAAGATGTCCACGTTC	PL-1
AAAGATGTCGATGAGG	PL-Lsp
AAAGCAAAGCCCAACC	PL-3
AAAGCAAAGTTAACGA	PL-Pcd
AAAGCAACACAGTCGC	PL-1
AAAGCAACAGCTGTGC	PL-robo2
AAAGCAAGTATCTGCA	PL-2
AAAGCAAGTCGGCTCA	PL-0
AAAGCAAGTGTGCGTC	PL-2
AAAGCAATCAGTGCAT	PL-0
AAAGTAGAGAAACGCC	PL-3
AAAGTAGAGAGTAAGG	PL-1
AAAGTAGAGCGTTGCC	PL-robo2
AAAGTAGAGGCATGTG	PL-Pcd
AAAGTAGAGTCAAGCG	PL-1
AAAGTAGCAACGATCT	PL-Rel
AAAGTAGCACAGTCGC	PL-0
AAAGTAGCACCATCCT	PL-0
AAAGTAGCAGTCTTCC	PL-robo2
AAAGTAGCATCGACGC	PL-1
AAAGTAGGTAAATGTG	PL-ImpL2
AAAGTAGGTAGCGCAA	PL-2
AAAGTAGGTGAGGGTT	PL-1
AAAGTAGGTTAGTGGG	PL-Pcd
AAAGTAGGTTGTTTGG	PL-2
AAAGTAGGTTTGTGTG	PL-Lsp
AAAGTAGTCAGGATCT	PL-1
AAAGTAGTCCGTTGTC	PL-3
AAAGTAGTCTGCAAGT	PL-robo2
AAAGTAGTCTTCGAGA	PL-1
AAATGCCAGAGCCCAA	PL-robo2
AAATGCCAGAGGTTGC	PL-1
AAATGCCCACAGTCGC	PL-3
AAATGCCCAGCTGCTG	PL-1
AAATGCCCATCGGACC	PL-1
AAATGCCGTCAACATC	PL-2
AAATGCCGTCCGCTGA	PL-3
AAATGCCGTCGATTGT	PL-2
AAATGCCGTGGCAAAC	PL-Lsp
AAATGCCGTTCTGAAC	PL-0
AAATGCCGTTTGCATG	PL-Rel
AAATGCCTCGTCGTTC	PL-0
AAATGCCTCTAACTCT	PL-Rel
AAATGCCTCTCGATGA	PL-2
AAATGCCTCTCGTATT	PL-robo2
AACACGTAGCACCGCT	PL-Pcd
AACACGTAGTCAATAG	PL-Pcd
AACACGTAGTTAACGA	PL-Rel
AACACGTCAAAGGCGT	PL-1
AACACGTGTGCCTGTG	PL-Rel
AACACGTTCAGCTTAG	PL-2
AACACGTTCATAACCG	PL-robo2
AACACGTTCGTCTGAA	PL-0
AACCATGAGATCACGG	PL-Rel
AACCATGAGATCTGCT	PL-0
AACCATGAGCGATAGC	PL-vir1
AACCATGAGGCATGTG	PL-robo2
AACCATGCAGTAGAGC	PL-Lsp
AACCATGCATTTGCCC	PL-0
AACCATGGTACAGTGG	PL-3
AACCATGGTATAGGGC	PL-Pcd
AACCATGGTCATTAGC	PL-Rel
AACCATGTCACATAGC	PL-1
AACCATGTCACCCGAG	PL-2
AACCATGTCGTATCAG	PL-0
AACCATGTCTATCGCC	PL-2
AACCGCGAGAAACCGC	PL-robo2
AACCGCGAGAGTACCG	PL-0
AACCGCGAGATAGGAG	PL-Inos
AACCGCGAGGAGCGAG	PL-2
AACCGCGAGTATCGAA	PL-1
AACCGCGAGTTCGCAT	PL-3
AACCGCGCACACATGT	PL-2
AACCGCGCACATGTGT	LM-2
AACCGCGCACCCATGG	PL-2
AACCGCGCAGGGCATA	PL-robo2
AACCGCGCAGGTCGTC	PL-0
AACCGCGCAGTCCTTC	PL-2
AACCGCGCATATACCG	PL-2
AACCGCGGTAGTAGTA	PL-prolif
AACCGCGGTCCAAGTT	PL-3
AACCGCGGTGCACGAA	PL-3
AACCGCGTCCTTGCCA	PL-Lsp
AACCGCGTCGACGGAA	PL-0
AACCGCGTCGCGTTTC	PL-Rel
AACGTTGAGTCTTGCA	PL-0
AACGTTGAGTGATCGG	PL-vir1
AACGTTGAGTTTCCTT	PL-Rel
AACGTTGCAATCCAAC	PL-0
AACGTTGCACTTCTGC	PL-1
AACGTTGCAGTCGTGC	PL-Rel
AACGTTGCATCTATGG	PL-3
AACGTTGGTAGCTAAA	PL-1
AACGTTGGTGACAAAT	PL-0
AACGTTGGTGTCGCTG	PL-3
AACGTTGGTTGAGGTG	PL-2
AACGTTGTCCGGGTGT	PL-Rel
AACGTTGTCGGCGCTA	PL-Pcd
AACTCAGAGCAGGTCA	PL-robo2
AACTCAGAGTAAGTAC	PL-Rel
AACTCAGAGTACGTAA	PL-Inos
AACTCAGAGTGGGCTA	PL-2
AACTCAGAGTTTGCGT	PL-3
AACTCAGCAAACGTGG	PL-2
AACTCAGCACAGGCCT	PL-Lsp
AACTCAGCACGGTAAG	PL-2
AACTCAGCAGTAAGCG	PL-vir1
AACTCAGCATCCGGGT	PL-robo2
AACTCAGCATTGTGCA	PL-Rel
AACTCAGGTAAACGCG	PL-0
AACTCAGGTACCATCA	PL-0
AACTCAGTCAATACCG	PL-2
AACTCAGTCAGGCGAA	PL-0
AACTCAGTCATTCACT	PL-robo2
AACTCAGTCCTTTACA	PL-Rel
AACTCAGTCGGCTTGG	PL-robo2
AACTCAGTCTATCCTA	PL-0
AACTCCCAGCAGATCG	PL-2
AACTCCCAGTGCCATT	PL-Rel
AACTCCCAGTTGAGAT	PL-robo2
AACTCCCCACCACCAG	PL-2
AACTCCCCACCATGTA	PL-0
AACTCCCCAGCATACT	PL-Rel
AACTCCCCATCTATGG	PL-vir1
AACTCCCGTTATGCGT	PL-robo2
AACTCCCTCGCCTGTT	PL-2
AACTCCCTCGCGCCAA	PL-Rel
AACTCCCTCTTGAGGT	PL-0
AACTCTTAGCGATATA	PL-2
AACTCTTAGCGGCTTC	PL-1
AACTCTTAGTGAACAT	PL-0
AACTCTTAGTGTCCCG	PL-0
AACTCTTCAGACAAAT	PL-Lsp
AACTCTTCAGGATCGA	PL-Pcd
AACTCTTGTAGGGACT	PL-robo2
AACTCTTGTTGTCGCG	PL-Rel
AACTCTTTCATGTGGT	PL-0
AACTCTTTCCTTTCGG	PL-0
AACTCTTTCGCCCTTA	PL-3
AACTCTTTCGTTTGCC	PL-0
AACTGGTAGCCACCTG	PL-3
AACTGGTAGGAATCGC	PL-2
AACTGGTAGGCAAAGA	PL-0
AACTGGTAGGGAGTAA	PL-1
AACTGGTCAACGCACC	PL-1
AACTGGTCAATAGCGG	PL-3
AACTGGTCACCAGTTA	PL-1
AACTGGTGTTATGTGC	PL-3
AACTGGTTCGTAGGTT	PL-Rel
AACTTTCAGACTAAGT	PL-Rel
AACTTTCAGCCGATTT	PL-0
AACTTTCAGTAGTGCG	PL-robo2
AACTTTCAGTGTGGCA	PL-Inos
AACTTTCCAACTGCGC	PL-2
AACTTTCCAAGCCCAC	PL-robo2
AACTTTCCAATCGAAA	PL-Lsp
AACTTTCCAGACTCGC	PL-3
AACTTTCGTAATAGCA	PL-2
AACTTTCGTACAGCAG	PL-1
AACTTTCGTATATGAG	PL-0
AACTTTCGTCAATACC	PL-3
AACTTTCGTCGGCACT	PL-0
AACTTTCGTCTGCAAT	PL-Rel
AACTTTCGTGACTACT	PL-3
AACTTTCGTGCATCTA	PL-1
AACTTTCGTGCCTTGG	PL-Rel
AACTTTCTCTCCAACC	PL-Rel
AAGACCTAGCAGGCTA	PL-Pcd
AAGACCTAGCAGGTCA	PL-Rel
AAGACCTAGGTGTTAA	PL-0
AAGACCTCAAAGGCGT	PL-2
AAGACCTCACCATGTA	PL-1
AAGACCTCACGAAACG	PL-Pcd
AAGACCTCATGCCTAA	PL-prolif
AAGACCTGTGCAGGTA	PL-0
AAGACCTGTTAAGGGC	PL-0
AAGACCTGTTACGCGC	PL-0
AAGACCTGTTCACCTC	PL-0
AAGACCTTCACTCCTG	PL-0
AAGACCTTCCACGAAT	PL-3
AAGCCGCAGATGCGAC	PL-0
AAGCCGCAGCGCTCCA	PL-robo2
AAGCCGCAGGAATGGA	PL-Rel
AAGCCGCAGGATCGCA	PL-0
AAGCCGCAGTTACGGG	PL-1
AAGCCGCAGTTGAGTA	PL-1
AAGCCGCCAGACGCAA	PL-Rel
AAGCCGCCATGGTCAT	PL-Lsp
AAGCCGCGTAAAGTCA	PL-1
AAGCCGCGTAGGGACT	PL-Inos
AAGCCGCGTCTCTCGT	PL-1
AAGCCGCTCCATGAAC	PL-3
AAGCCGCTCCTCGCAT	PL-1
AAGCCGCTCGCACTCT	PL-3
AAGGAGCAGAGATGAG	PL-Lsp
AAGGAGCAGGTGGGTT	PL-0
AAGGAGCAGTGTTGAA	PL-Pcd
AAGGAGCCACTTCGAA	PL-Pcd
AAGGAGCCAGTCAGAG	PL-Lsp
AAGGAGCCATACTCTT	PL-2
AAGGAGCGTAGCGTAG	PL-2
AAGGAGCGTAGCTGCC	PL-2
AAGGAGCGTGGGTCAA	PL-2
AAGGAGCGTGTTGAGG	PL-2
AAGGAGCGTGTTGGGA	PL-3
AAGGAGCTCAGCAACT	PL-0
AAGGAGCTCAGTCCCT	PL-2
AAGGAGCTCCCAACGG	PL-1
AAGGAGCTCGGTGTTA	PL-2
AAGGAGCTCGTGGACC	PL-Pcd
AAGGAGCTCTCGATGA	PL-1
AAGGAGCTCTGCTGCT	PL-AMP
AAGGAGCTCTTCATGT	PL-Rel
AAGGCAGAGAATTCCC	PL-0
AAGGCAGAGATCACGG	PL-3
AAGGCAGAGCCTCGTG	PL-Lsp
AAGGCAGCAAATACAG	PL-vir1
AAGGCAGCACAGTCGC	PL-1
AAGGCAGCACATGTGT	PL-robo2
AAGGCAGCACTGAAGG	PL-1
AAGGCAGCAGAGCCAA	PL-1
AAGGCAGGTAGCTGCC	PL-0
AAGGCAGGTCACAAGG	PL-Rel
AAGGCAGGTCGAAAGC	PL-1
AAGGCAGGTCTTCAAG	PL-2
AAGGCAGGTGTTGAGG	PL-Rel
AAGGCAGTCCGAGCCA	PL-1
AAGGCAGTCGCGTTTC	PL-0
AAGGTTCAGACTGTAA	PL-2
AAGGTTCAGAGACTTA	PL-0
AAGGTTCAGAGCTATA	PL-3
AAGGTTCCAACCGCCA	PL-2
AAGGTTCCAATGTTGC	PL-0
AAGGTTCCAGGGTACA	PL-Lsp
AAGGTTCCATAGAAAC	PL-1
AAGGTTCCATCCCACT	PL-0
AAGGTTCGTGATAAGT	PL-2
AAGGTTCGTTAGATGA	PL-0
AAGGTTCTCACTTACT	PL-Rel
AAGGTTCTCAGTACGT	PL-3
AAGGTTCTCTTAGCCC	PL-1
AAGTCTGAGAGTCGGT	PL-3
AAGTCTGCAAATCCGT	PL-0
AAGTCTGCAATGTTGC	PL-2
AAGTCTGCACATTCGA	PL-0
AAGTCTGCACCAGCAC	PL-Rel
AAGTCTGCACCGTTGG	PL-Rel
AAGTCTGCAGACAGGT	PL-0
AAGTCTGCATATACGC	PL-2
AAGTCTGGTACCCAAT	PL-Rel
AAGTCTGGTACGCACC	PL-0
AAGTCTGGTAGTAGTA	PL-2
AAGTCTGGTCAAACTC	PL-2
AAGTCTGGTCCGTTAA	PL-3
AAGTCTGGTCTAAAGA	PL-1
AAGTCTGGTCTAGTGT	PL-Rel
AAGTCTGGTGAAAGAG	PL-Pcd
AAGTCTGGTGACGGTA	PL-robo2
AAGTCTGGTGTGCCTG	PL-0
AAGTCTGTCAGTTTGG	PL-Lsp
AAGTCTGTCCCTAATT	PL-0
AAGTCTGTCGTCTGAA	PL-Lsp
AAGTCTGTCTTCTGGC	PL-2
AATCCAGCACCCATTC	PL-3
AATCCAGCAGGCTCAC	PL-1
AATCCAGGTACAGCAG	PL-Rel
AATCCAGGTCCATGAT	PL-Rel
AATCCAGGTGAACCTT	PL-2
AATCCAGGTGATAAAC	PL-0
AATCCAGGTTAGTGGG	PL-0
AATCCAGGTTATCACG	PL-1
AATCCAGTCACAGTAC	PL-1
AATCCAGTCAGCCTAA	PL-1
AATCCAGTCCTCCTAG	PL-robo2
AATCCAGTCTCGCTTG	PL-3
AATCCAGTCTGCGTAA	PL-0
AATCGGTAGAAAGTGG	PL-Inos
AATCGGTAGAAGGTTT	PL-Pcd
AATCGGTAGACGCTTT	PL-1
AATCGGTAGACTGGGT	PL-Lsp
AATCGGTAGAGGTAGA	PL-2
AATCGGTAGCCCTAAT	PL-3
AATCGGTAGCGTGTCC	PL-vir1
AATCGGTAGCTCAACT	PL-Rel
AATCGGTAGGCTCATT	PL-Rel
AATCGGTAGTACTTGC	PL-2
AATCGGTCACAGCGTC	PL-vir1
AATCGGTCACAGGCCT	PL-0
AATCGGTCATCGGAAG	PL-robo2
AATCGGTCATGGGAAC	PL-Rel
AATCGGTCATTGGGCC	PL-3
AATCGGTGTACGCTGC	PL-3
AATCGGTGTATAATGG	PL-1
AATCGGTTCCTGTAGA	PL-1
AATCGGTTCTCCAGGG	PL-0
ACACCAAAGCTAGTTC	PL-AMP
ACACCAAAGGATGGTC	PL-3
ACACCAAAGTGCCAGA	PL-Rel
ACACCAAAGTTGCAGG	PL-1
ACACCAACAAAGCAAT	PL-Lsp
ACACCAACAAGTAGTA	PL-Rel
ACACCAACAATCACAC	PL-3
ACACCAACAATTCCTT	PL-2
ACACCAACACACGCTG	PL-1
ACACCAAGTAAGTAGT	PL-Rel
ACACCAAGTAGCAAAT	PL-Rel
ACACCAAGTCTCTTAT	PL-prolif
ACACCAAGTGTCTGAT	PL-vir1
ACACCAATCAATAAGG	PL-2
ACACCAATCATCACCC	PL-2
ACACCAATCATTGCCC	PL-Rel
ACACCAATCCCTTGCA	PL-Pcd
ACACCAATCTGTCTCG	PL-3
ACACCCTAGAGAGCTC	PL-0
ACACCCTAGGCATGGT	PL-ImpL2
ACACCCTAGGCTAGGT	PL-vir1
ACACCCTAGGGTGTTG	PL-0
ACACCCTAGTAGGCCA	PL-3
ACACCCTCAAGTTCTG	PL-2
ACACCCTCAATCACAC	PL-1
ACACCCTCACCCAGTG	PL-2
ACACCCTCACTTACGA	PL-0
ACACCCTGTGCCTGGT	PL-2
ACACCCTGTTACCAGT	PL-vir1
ACACCCTGTTACTGAC	PL-1
ACACCCTGTTCGTTGA	PL-2
ACACCCTTCAGCGATT	PL-2
ACACCCTTCAGTACGT	PL-Lsp
ACACCCTTCTAGCACA	PL-1
ACACCCTTCTGCAAGT	PL-Rel
ACACCGGCAAAGTGCG	PL-vir1
ACACCGGCAACTTGAC	PL-1
ACACCGGCAGTATAAG	PL-0
ACACCGGCATAGGATA	PL-1
ACACCGGCATGCCTTC	PL-Inos
ACACCGGGTACCGTTA	PL-0
ACACCGGGTCAGCTAT	PL-2
ACACCGGGTCCGTCAG	PL-0
ACACCGGGTGGTCCGT	PL-Rel
ACACCGGGTTGATTCG	PL-0
ACACCGGTCATGCATG	PL-1
ACACCGGTCGTCACGG	PL-0
ACACCGGTCGTCCGTT	PL-1
ACACCGGTCTATCGCC	PL-2
ACACTGAAGATCGGGT	PL-0
ACACTGAAGATGTGTA	PL-2
ACACTGAAGCTGAAAT	PL-2
ACACTGAAGTCCGTAT	PL-2
ACACTGAAGTTGAGTA	PL-3
ACACTGACAAGCGTAG	PL-1
ACACTGACAATACGCT	PL-2
ACACTGACACATGGGA	PL-1
ACACTGACACCTTGTC	PL-Rel
ACACTGACAGACAGGT	PL-Rel
ACACTGACAGCAGTTT	PL-2
ACACTGACAGTCCTTC	PL-Pcd
ACACTGACAGTTTACG	PL-robo2
ACACTGACATAGTAAG	PL-1
ACACTGACATCACAAC	PL-2
ACACTGAGTCTACCTC	PL-Rel
ACACTGAGTGCTTCTC	PL-Rel
ACACTGAGTTTGTTTC	PL-Lsp
ACACTGATCAAGGTAA	PL-2
ACACTGATCCCATTAT	PL-2
ACAGCCGAGAAGGTGA	PL-2
ACAGCCGAGCTGTCTA	PL-vir1
ACAGCCGAGTAGATGT	PL-Rel
ACAGCCGCACCGAATT	PL-2
ACAGCCGCACGAAACG	PL-Lsp
ACAGCCGCATGAACCT	PL-2
ACAGCCGCATTACCTT	CC
ACAGCCGGTCAATACC	PL-0
ACAGCCGGTTTGTTTC	PL-Rel
ACAGCCGTCAAGCCTA	PL-Lsp
ACAGCCGTCTGCAAGT	PL-2
ACAGCCGTCTGCGACG	PL-Rel
ACAGCCGTCTTGTATC	PL-1
ACAGCTAAGACTACAA	PL-robo2
ACAGCTAAGAGCCTAG	PL-Lsp
ACAGCTAAGATGTCGG	PL-1
ACAGCTAAGGAATCGC	PL-1
ACAGCTAAGTTCGCAT	PL-0
ACAGCTACACCAGATT	PL-2
ACAGCTACAGCTTCGG	PL-2
ACAGCTACATGCCACG	PL-1
ACAGCTAGTAAGGGAA	PL-1
ACAGCTAGTCATGCCG	PL-Rel
ACAGCTAGTGTGTGCC	PL-Pcd
ACAGCTATCAGTACGT	PL-Rel
ACAGCTATCCAGGGCT	PL-robo2
ACAGCTATCTAGAGTC	PL-1
ACATACGAGATGCCAG	PL-0
ACATACGAGATGTGGC	PL-3
ACATACGAGATTACCC	PL-2
ACATACGAGCCTCGTG	PL-1
ACATACGAGCTAGGCA	PL-0
ACATACGCAAACTGTC	PL-robo2
ACATACGCAAGTTCTG	PL-2
ACATACGCACGAAACG	PL-Inos
ACATACGCACGGATAG	PL-Pcd
ACATACGCACTGTGTA	PL-2
ACATACGCACTTCGAA	PL-AMP
ACATACGCATCATCCC	PL-2
ACATACGGTCCAGTAT	PL-2
ACATACGGTGGTCCGT	PL-2
ACATCAGAGACCCACC	PL-1
ACATCAGAGTCAATAG	PL-0
ACATCAGAGTGCGATG	PL-1
ACATCAGCAAGAAAGG	PL-2
ACATCAGCACAGGCCT	PL-0
ACATCAGCAGTCAGAG	PL-vir1
ACATCAGCATCCGCGA	PL-1
ACATCAGCATGATCCA	PL-2
ACATCAGGTCGTGGCT	PL-Pcd
ACATCAGGTCTCACCT	PL-3
ACATCAGTCAGCGACC	PL-1
ACATCAGTCCGTAGTA	PL-2
ACATCAGTCGGACAAG	PL-Inos
ACATCAGTCGTCTGAA	PL-1
ACATGGTAGAGATGAG	PL-robo2
ACATGGTAGCATCATC	PL-2
ACATGGTAGTTGTCGT	PL-Rel
ACATGGTCAAACTGCT	PL-Rel
ACATGGTCAATCTGCA	PL-robo2
ACATGGTCAATGTTGC	PL-1
ACATGGTCACGACTCG	PL-vir1
ACATGGTCAGCCTGTG	PL-robo2
ACATGGTCAGCTATTG	PL-1
ACATGGTCATGGGAAC	PL-Rel
ACATGGTGTCAACTGT	PL-Pcd
ACATGGTTCACGGTTA	PL-1
ACATGGTTCTAACGGT	PL-robo2
ACATGGTTCTCCGGTT	PL-Pcd
ACCAGTAAGAAGGCCT	PL-3
ACCAGTAAGACCACGA	PL-1
ACCAGTAAGAGCTATA	PL-3
ACCAGTAAGCAACGGT	PL-2
ACCAGTAAGTCAAGGC	PL-robo2
ACCAGTAAGTCGCCGT	PL-1
ACCAGTACAAAGTGCG	PL-robo2
ACCAGTACACCACGTG	PL-Pcd
ACCAGTACATCCTTGC	PL-Lsp
ACCAGTACATGTTCCC	PL-1
ACCAGTAGTACATGTC	PL-1
ACCAGTAGTATTACCG	PL-2
ACCAGTATCACATACG	PL-2
ACCAGTATCACGCGGT	PL-Rel
ACCAGTATCAGTACGT	PL-2
ACCAGTATCCAAAGTC	PL-1
ACCAGTATCCGTCAAA	PL-1
ACCAGTATCGTACCGG	PL-Lsp
ACCAGTATCGTATCAG	PL-Rel
ACCCACTAGCCGTCGT	PL-Rel
ACCCACTAGCGTCAAG	PL-1
ACCCACTAGCTAACAA	PL-2
ACCCACTAGCTAGTGG	PL-0
ACCCACTAGGCATTGG	PL-3
ACCCACTAGGGCACTA	PL-3
ACCCACTAGGTGCAAC	PL-2
ACCCACTCATCGGACC	PL-vir1
ACCCACTGTGCGGTAA	PL-0
ACCCACTGTTGTGGAG	PL-2
ACCCACTTCACTCTTA	PL-1
ACCCACTTCACTGGGC	PL-vir1
ACCCACTTCAGGCGAA	PL-Rel
ACCCACTTCGTAGGTT	PL-1
ACCGTAAAGACATAAC	PL-Pcd
ACCGTAAAGCTACCTA	PL-Inos
ACCGTAACAAGCGAGT	PL-2
ACCGTAACACCCAGTG	PL-robo2
ACCGTAACACTCAGGC	PL-1
ACCGTAACAGCCACCA	PL-2
ACCGTAACATACTCTT	PL-2
ACCGTAAGTCTCTTAT	PL-Rel
ACCGTAATCGATGAGG	PL-3
ACCTTTAAGAGACTTA	PL-1
ACCTTTAAGCGTTCCG	PL-1
ACCTTTAAGGCATGTG	PL-3
ACCTTTAAGTTACCCA	PL-Rel
ACCTTTACAATCTGCA	PL-1
ACCTTTACAGGGTATG	PL-0
ACCTTTAGTAAATACG	PL-Pcd
ACCTTTAGTAGTAGTA	PL-Rel
ACCTTTAGTGGCTCCA	PL-2
ACCTTTAGTTTCGCTC	PL-1
ACCTTTATCACCGGGT	PL-0
ACCTTTATCACCGTAA	PL-2
ACCTTTATCCACTGGG	PL-0
ACCTTTATCCTTTCGG	PL-0
ACCTTTATCGGAATCT	PL-Rel
ACCTTTATCTTGCATT	PL-2
ACCTTTATCTTTACAC	PL-Rel
ACGAGCCCACACCGAC	PL-1
ACGAGCCCACGAGAGT	PL-0
ACGAGCCCAGCTCGCA	PL-0
ACGAGCCCATCGATTG	PL-Pcd
ACGAGCCGTAGCCTCG	PL-2
ACGAGCCGTCAATGTC	PL-Rel
ACGAGCCGTTGTTTGG	PL-0
ACGAGCCGTTTAGGAA	PL-2
ACGAGCCTCAAGATCC	PL-vir1
ACGAGCCTCAGCAACT	PL-3
ACGAGCCTCAGTCCCT	PL-1
ACGAGCCTCCTTTCGG	PL-2
ACGAGGAAGACAGACC	PL-Lsp
ACGAGGAAGCGCTTAT	PL-2
ACGAGGAAGGTGATTA	PL-1
ACGAGGAAGTGTACGG	PL-1
ACGAGGACAACGATGG	PL-1
ACGAGGACACACATGT	PL-2
ACGAGGACACCATGTA	PL-Rel
ACGAGGACACGTAAGG	PL-2
ACGAGGACACTTCTGC	PL-2
ACGAGGAGTCACAAGG	PL-robo2
ACGAGGAGTCCGTTAA	PL-Pcd
ACGAGGAGTGTAACGG	PL-3
ACGAGGAGTTAAGAAC	PL-1
ACGAGGATCGGTGTTA	PL-1
ACGAGGATCTTGGGTA	PL-0
ACGATACAGACTACAA	PL-2
ACGATACAGCCTATGT	PL-2
ACGATACAGTGATCGG	PL-3
ACGATACAGTGGAGTC	PL-1
ACGATACAGTGTCCCG	PL-2
ACGATACCACCATGTA	PL-1
ACGATACCACGTCTCT	PL-1
ACGATACCAGCCTGTG	PL-3
ACGATACCATGGGAAC	PL-vir1
ACGATACCATTCTCAT	PL-0
ACGATACGTAAGAGAG	PL-robo2
ACGATACGTATAGTAG	PL-vir1
ACGATACGTCCAGTGC	PL-1
ACGATACGTCGAATCT	PL-AMP
ACGATACTCAAGCCTA	PL-Pcd
ACGATACTCATTGCGA	PL-Lsp
ACGATACTCTCAAGTG	PL-Inos
ACGATGTAGGGTTTCT	PL-2
ACGATGTAGTCGAGTG	PL-1
ACGATGTCAATCACAC	PL-prolif
ACGATGTCACGCTTTC	PL-0
ACGATGTCAGCTTCGG	PL-0
ACGATGTCATGAGCGA	PL-robo2
ACGATGTGTCAGCTAT	PL-2
ACGATGTTCAAGATCC	PL-Rel
ACGATGTTCCAGAAGG	PL-0
ACGATGTTCGGGAGTA	PL-Lsp
ACGATGTTCGGTCCGA	PL-2
ACGATGTTCGTGACAT	PL-1
ACGATGTTCGTGGTCG	PL-1
ACGATGTTCTGCGTAA	PL-0
ACGCAGCAGAGATGAG	PL-2
ACGCAGCAGGCCCTCA	PL-2
ACGCAGCAGGTGCTAG	PL-1
ACGCAGCCAATGGAAT	PL-3
ACGCAGCCAGATTGCT	PL-0
ACGCAGCCAGGGTATG	PL-Inos
ACGCAGCCAGTCGTGC	PL-1
ACGCAGCCATGGTCAT	PL-robo2
ACGCAGCCATTGTGCA	PL-0
ACGCAGCGTACCAGTT	PL-2
ACGCAGCGTACCTACA	PL-Inos
ACGCAGCGTGCACTTA	PL-0
ACGCAGCGTGTTTGGT	PL-2
ACGCAGCTCTGCCAGG	PL-0
ACGCCAGAGACTAAGT	PL-Rel
ACGCCAGAGATTACCC	PL-Pcd
ACGCCAGAGCGCCTCA	PL-2
ACGCCAGAGGAACTGC	PL-Rel
ACGCCAGAGGGTCTCC	PL-0
ACGCCAGAGTGGTCCC	PL-0
ACGCCAGCAAGCCTAT	PL-0
ACGCCAGCACATTTCT	PL-0
ACGCCAGCAGTTCATG	PL-1
ACGCCAGCATGAAGTA	PL-AMP
ACGCCAGCATGCATGT	PL-0
ACGCCAGGTAGTACCT	PL-0
ACGCCAGGTGACAAAT	PL-1
ACGCCAGGTTAAAGTG	PL-Rel
ACGCCAGGTTCATGGT	PL-0
ACGCCAGTCAAAGACA	PL-robo2
ACGCCAGTCACTGGGC	PL-0
ACGCCAGTCTTCGAGA	PL-2
ACGCCGAAGACAAAGG	PL-1
ACGCCGAAGGCCCTTG	PL-1
ACGCCGACAAATTGCC	PL-2
ACGCCGACACAAGTAA	PL-3
ACGCCGACAGCATACT	PL-1
ACGCCGACAGCTTCGG	PL-0
ACGCCGACATATGGTC	PL-robo2
ACGCCGACATCCTAGA	PL-2
ACGCCGAGTAACGACG	PL-3
ACGCCGAGTAGAGCTG	PL-prolif
ACGCCGAGTCACACGC	PL-0
ACGCCGAGTCATATCG	PL-0
ACGCCGAGTTACCGAT	PL-2
ACGCCGAGTTGGTGGA	PL-prolif
ACGCCGATCGGCCGAT	LM-1
ACGCCGATCTGGGCCA	PL-0
ACGGAGAAGAAGGGTA	PL-2
ACGGAGAAGCGGATCA	PL-1
ACGGAGAAGCTCCCAG	PL-1
ACGGAGAAGTTCGATC	PL-0
ACGGAGACACATAACC	PL-Rel
ACGGAGACACCGTTGG	PL-0
ACGGAGACACGCGAAA	PL-0
ACGGAGACACTTAACG	PL-0
ACGGAGACAGCTGTTA	PL-robo2
ACGGAGACATGTCTCC	PL-robo2
ACGGAGAGTGTGCGTC	PL-3
ACGGAGATCAGCTGGC	PL-2
ACGGAGATCCCAGGTG	PL-2
ACGGAGATCCGATATG	PL-Lsp
ACGGAGATCCTATTCA	PL-vir1
ACGGAGATCTCGAGTA	PL-Rel
ACGGAGATCTGGTGTA	PL-1
ACGGCCAAGAATGTTG	PL-0
ACGGCCAAGAGCAATT	PL-1
ACGGCCAAGTACATGA	PL-0
ACGGCCAAGTTCGCAT	PL-1
ACGGCCACAATCCAAC	PL-Rel
ACGGCCACACTGCCAG	PL-vir1
ACGGCCACAGATGGCA	PL-3
ACGGCCACAGTCAGCC	PL-0
ACGGCCACATACAGCT	PL-Lsp
ACGGCCACATTGGGCC	PL-1
ACGGCCAGTCCGTGAC	PL-robo2
ACGGCCAGTGCGGTAA	PL-Rel
ACGGCCAGTGTATGGG	PL-robo2
ACGGCCAGTGTCAATC	PL-1
ACGGCCAGTTCCACTC	PL-Pcd
ACGGCCATCCCTTGCA	PL-1
ACGGCCATCTGAAAGA	PL-2
ACGGCCATCTTGAGGT	PL-0
ACGGGCTAGAAGCCCA	PL-Pcd
ACGGGCTAGACACGAC	PL-1
ACGGGCTAGATGCGAC	PL-0
ACGGGCTAGATGGGTC	PL-2
ACGGGCTAGCCAGAAC	PL-vir1
ACGGGCTAGGCATGTG	PL-1
ACGGGCTCAAGCGCTC	PL-2
ACGGGCTGTTCGGCAC	PL-Rel
ACGGGCTTCCAAGCCG	PL-Inos
ACGGGCTTCTAACTGG	PL-3
ACGGGCTTCTTCTGGC	PL-3
ACGGGTCAGAACAATC	PL-Pcd
ACGGGTCAGATGTTAG	PL-Rel
ACGGGTCAGCGTCTAT	PL-2
ACGGGTCAGTACGACG	PL-1
ACGGGTCCAAGTAATG	PL-1
ACGGGTCCAGACGCTC	PL-2
ACGGGTCGTACATCCA	PL-1
ACGGGTCGTAGAGTGC	PL-1
ACGGGTCGTGAGTATA	PL-3
ACGGGTCGTTACAGAA	PL-vir1
ACGGGTCTCATGTAGC	PL-0
ACGGGTCTCATTATCC	PL-vir1
ACGGGTCTCCTCGCAT	PL-3
ACGGGTCTCTATCGCC	PL-vir1
ACGTCAAAGAGTGAGA	PL-Rel
ACGTCAAAGCCAGTTT	PL-1
ACGTCAACACGAGAGT	PL-2
ACGTCAAGTAGCTAAA	PL-2
ACGTCAAGTAGGGTAC	PL-prolif
ACGTCAATCACATGCA	PL-3
ACGTCAATCTAACTCT	PL-robo2
ACGTCAATCTGCGACG	PL-Pcd
ACGTCAATCTGTACGA	PL-robo2
ACTATCTCAATGTTGC	PL-0
ACTATCTCACAGACAG	PL-1
ACTATCTCAGTCAGCC	PL-2
ACTATCTCATCCAACA	PL-Pcd
ACTATCTGTTAAGACA	PL-Rel
ACTATCTTCCGTACAA	CC
ACTATCTTCCGTAGGC	PL-0
ACTATCTTCGTGGGAA	CC
ACTATCTTCTATCCTA	PL-0
ACTGAACAGAACAATC	PL-3
ACTGAACAGACAGGCT	PL-robo2
ACTGAACAGACGCACA	PL-Rel
ACTGAACAGACTAGGC	PL-Rel
ACTGAACAGAGGACGG	PL-0
ACTGAACAGCGTTGCC	PL-2
ACTGAACAGGTGCAAC	PL-0
ACTGAACCACACGCTG	PL-2
ACTGAACCACATGTGT	PL-vir1
ACTGAACGTATGAATG	PL-2
ACTGAACGTCGAGTTT	PL-3
ACTGAACGTGTGAAAT	PL-0
ACTGAACGTTAGAACA	PL-3
ACTGAACGTTGCGCAC	PL-Rel
ACTGAACTCATAAAGG	PL-Lsp
ACTGAACTCGTGACAT	PL-3
ACTGAACTCTGTCTAT	PL-0
ACTGAGTAGAGTAAGG	PL-Rel
ACTGAGTAGCCGCCTA	PL-2
ACTGAGTAGCTGAACG	PL-robo2
ACTGAGTAGGACACCA	PL-Rel
ACTGAGTAGGCATTGG	PL-1
ACTGAGTAGGTGCTTT	PL-0
ACTGAGTCACTGTCGG	PL-Rel
ACTGAGTCATCACCCT	PL-Lsp
ACTGAGTGTAAACACA	PL-vir1
ACTGAGTGTACTCAAC	PL-Rel
ACTGAGTGTCTCAACA	PL-0
ACTGAGTGTCTGGAGA	PL-Rel
ACTGAGTTCATGCATG	PL-robo2
ACTGAGTTCCAGAAGG	PL-Pcd
ACTGAGTTCCGAACGC	PL-2
ACTGATGAGATTACCC	PL-Inos
ACTGATGAGTGTCCCG	PL-0
ACTGATGCAACTGCGC	PL-vir1
ACTGATGCATCGGACC	PL-Lsp
ACTGATGGTATGAAAC	PL-0
ACTGATGGTGTGAAAT	PL-1
ACTGATGGTTGGTAAA	PL-Rel
ACTGATGTCCATGAGT	PL-0
ACTGATGTCCGTACAA	PL-2
ACTGATGTCTAGAGTC	PL-1
ACTGATGTCTATGTGG	PL-2
ACTGCTCAGAGTGACC	PL-Rel
ACTGCTCAGATCCTGT	PL-2
ACTGCTCAGCGTCAAG	PL-Inos
ACTGCTCCAAGGACAC	PL-2
ACTGCTCCAGGTCTCG	PL-2
ACTGCTCCATTCACTT	PL-robo2
ACTGCTCGTCCAGTGC	PL-Inos
ACTGCTCGTCCGTGAC	PL-0
ACTGCTCGTCTCCCTA	PL-Pcd
ACTGCTCGTGGGTCAA	PL-2
ACTGCTCGTGTTGAGG	PL-3
ACTGCTCGTTCTCATT	PL-1
ACTGCTCTCGCCATAA	PL-prolif
ACTGCTCTCTTACCTA	PL-3
ACTGTCCAGAAGCCCA	PL-1
ACTGTCCAGCCTTGAT	PL-Rel
ACTGTCCAGCTAGTTC	PL-1
ACTGTCCAGGACAGAA	PL-Inos
ACTGTCCAGGCCCGTT	PL-Rel
ACTGTCCAGGTGCTAG	PL-1
ACTGTCCCAAACCCAT	PL-Rel
ACTGTCCCATTAGGCT	PL-1
ACTGTCCCATTCCTGC	PL-2
ACTGTCCGTCTTGTCC	PL-vir1
ACTGTCCGTGCAGACA	PL-0
ACTGTCCGTGGCGAAT	PL-Rel
ACTGTCCGTTTGTGTG	PL-0
ACTGTCCTCAAACAAG	PL-2
ACTGTCCTCCGTAGGC	PL-vir1
ACTGTCCTCTGCTGTC	PL-Inos
ACTGTCCTCTTTAGGG	PL-vir1
ACTTACTAGGAACTGC	PL-0
ACTTACTAGTACGATA	PL-vir1
ACTTACTAGTGTGAAT	PL-3
ACTTACTCAATGGACG	PL-1
ACTTACTCATACTACG	PL-2
ACTTACTCATGCTAGT	PL-1
ACTTACTGTCGGCTCA	PL-Rel
ACTTACTGTCTTCAAG	PL-robo2
ACTTACTGTGCCTGGT	PL-1
ACTTACTTCAGTCCCT	PL-2
ACTTACTTCTGTGCAA	PL-robo2
ACTTGTTAGATATGCA	PL-2
ACTTGTTCAAAGGTGC	PL-vir1
ACTTGTTCACGAGAGT	PL-0
ACTTGTTCACGGTTTA	PL-Pcd
ACTTGTTCAGGGAGAG	PL-robo2
ACTTGTTCATGCTAGT	PL-robo2
ACTTGTTGTAGGCTGA	CC
ACTTGTTGTCCGTGAC	PL-vir1
ACTTGTTGTGCTCTTC	PL-0
ACTTGTTTCAGTTCGA	PL-3
ACTTTCAAGAGGTACC	PL-0
ACTTTCAAGCAACGGT	PL-robo2
ACTTTCAAGCAGGCTA	PL-Rel
ACTTTCAAGTAGATGT	PL-0
ACTTTCACACAGAGGT	PL-1
ACTTTCAGTCAGAGGT	PL-robo2
ACTTTCAGTCTTCGTC	PL-1
ACTTTCATCATCATTC	PL-2
ACTTTCATCGATGAGG	PL-1
AGAATAGAGAAGGCCT	PL-2
AGAATAGAGATCCCAT	PL-2
AGAATAGAGCCACGCT	PL-3
AGAATAGAGCGTAATA	PL-2
AGAATAGAGCTACCGC	PL-1
AGAATAGAGCTCTCGG	PL-2
AGAATAGCAAGTTCTG	PL-Pcd
AGAATAGCAGACGCCT	PL-1
AGAATAGGTAAATGTG	PL-2
AGAATAGGTACGCACC	PL-Rel
AGAATAGGTACTCAAC	PL-Rel
AGAATAGGTCGATTGT	PL-Rel
AGAATAGGTCTTCGTC	PL-2
AGAATAGGTGTCAATC	PL-3
AGAATAGTCACTCCTG	PL-vir1
AGAATAGTCGTGGGAA	PL-2
AGAATAGTCGTGGTCG	PL-3
AGAATAGTCTCGATGA	PL-0
AGAATAGTCTTAGCCC	PL-Inos
AGACGTTAGCCGTCGT	PL-2
AGACGTTAGTCCTCCT	PL-robo2
AGACGTTCAAGTTAAG	PL-robo2
AGACGTTCACAAGACG	PL-Inos
AGACGTTCACGGCGTT	PL-2
AGACGTTCATCATCCC	PL-0
AGACGTTCATGGGAAC	PL-2
AGACGTTCATTGAGCT	PL-0
AGACGTTGTATAGTAG	PL-1
AGACGTTGTATTCTCT	PL-1
AGACGTTGTCCTCTTG	PL-1
AGACGTTGTGCCTGTG	PL-1
AGACGTTGTGGTGTAG	PL-0
AGACGTTGTTAGGGTG	PL-0
AGACGTTTCACCCGAG	PL-Rel
AGACGTTTCCGCATCT	PL-2
AGACGTTTCGGGAGTA	PL-0
AGACGTTTCTACTCAT	PL-robo2
AGAGCGAAGCCCAATT	PL-1
AGAGCGAAGCTACCTA	PL-0
AGAGCGAAGGGTGTGT	PL-2
AGAGCGAAGGTAGCCA	PL-0
AGAGCGAAGTGGAGTC	PL-2
AGAGCGACACGTAAGG	PL-0
AGAGCGACATGGGACA	PL-2
AGAGCGACATTACCTT	PL-Inos
AGAGCGAGTATATGAG	PL-Rel
AGAGCGAGTCAAAGAT	PL-1
AGAGCGAGTGCACCAC	PL-3
AGAGCGAGTGGCCCTA	PL-2
AGAGCGATCCAGTATG	PL-0
AGAGCGATCGTGGGAA	PL-2
AGAGCGATCTGTTTGT	PL-Rel
AGAGCTTAGAAGGTGA	PL-0
AGAGCTTAGGAGTTTA	PL-0
AGAGCTTAGGGTCTCC	PL-vir1
AGAGCTTAGTAGGCCA	PL-Rel
AGAGCTTAGTCCTCCT	PL-0
AGAGCTTCAAATCCGT	PL-2
AGAGCTTCACTAAGTC	PL-2
AGAGCTTCAGGCTGAA	PL-1
AGAGCTTCATGCAACT	PL-0
AGAGCTTGTATAGGTA	PL-3
AGAGCTTGTCAAAGCG	PL-1
AGAGCTTGTCTCGTTC	PL-1
AGAGCTTGTTACGTCA	PL-vir1
AGAGCTTGTTTGACTG	PL-prolif
AGAGCTTTCACAGGCC	PL-3
AGAGCTTTCACTTACT	PL-0
AGAGCTTTCATGGTCA	PL-3
AGAGCTTTCGCATGGC	PL-Rel
AGAGCTTTCTGCGTAA	PL-2
AGAGTGGAGAAGAAGC	PL-2
AGAGTGGAGAGATGAG	PL-2
AGAGTGGAGCATCATC	PL-2
AGAGTGGAGCGTGAAC	PL-0
AGAGTGGAGGAGTTGC	PL-1
AGAGTGGCAAGGCTCC	PL-Pcd
AGAGTGGGTAACGACG	PL-robo2
AGAGTGGGTCATTAGC	PL-vir1
AGAGTGGTCAAACCAC	PL-vir1
AGAGTGGTCAAGAAGT	PL-Inos
AGATCTGAGACAATAC	PL-Rel
AGATCTGAGATGTTAG	PL-1
AGATCTGAGCACAGGT	PL-Inos
AGATCTGAGCGATGAC	PL-1
AGATCTGAGTACGATA	PL-Pcd
AGATCTGCACCACCAG	PL-1
AGATCTGCACCACGTG	PL-2
AGATCTGCACGTGAGA	PL-Rel
AGATCTGCACTTCTGC	PL-Lsp
AGATCTGCAGTAACGG	PL-Pcd
AGATCTGCATGGGACA	PL-2
AGATCTGGTACAGCAG	PL-2
AGATCTGGTACCGAGA	PL-3
AGATCTGGTCCAGTTA	PL-1
AGATCTGGTCGAGTTT	PL-Rel
AGATCTGTCAACGGGA	PL-3
AGATCTGTCATGCAAC	PL-2
AGATCTGTCCCTAATT	PL-1
AGATCTGTCCTGCCAT	PL-1
AGATCTGTCGACCAGC	PL-robo2
AGATCTGTCTATCCCG	PL-Pcd
AGATCTGTCTCTGCTG	PL-0
AGATTGCAGAGCTGGT	PL-Rel
AGATTGCAGGCGCTCT	PL-1
AGATTGCAGGGCATGT	PL-2
AGATTGCAGGGTATCG	PL-2
AGATTGCCACCTATCC	PL-Rel
AGATTGCCAGGCAGTA	PL-3
AGATTGCGTAAACGCG	PL-vir1
AGATTGCGTATAGGGC	PL-Pcd
AGATTGCGTCCAACTA	PL-0
AGATTGCGTCTAAACC	PL-2
AGATTGCGTCTCCCTA	PL-2
AGATTGCGTTAAGACA	PL-2
AGATTGCTCATATCGG	PL-robo2
AGATTGCTCCAAGTAC	PL-3
AGATTGCTCTAGAGTC	PL-0
AGCAGCCAGATAGCAT	PL-1
AGCAGCCAGGGCACTA	PL-Rel
AGCAGCCAGTGCAAGC	PL-2
AGCAGCCCAGTTAACC	PL-1
AGCAGCCCAGTTCCCT	PL-2
AGCAGCCCATGTTGAC	PL-1
AGCAGCCCATTGTGCA	PL-3
AGCAGCCGTCGGATCC	PL-Lsp
AGCAGCCTCCCGGATG	PL-1
AGCAGCCTCCGCAAGC	PL-1
AGCAGCCTCGGACAAG	PL-2
AGCAGCCTCGGATGGA	PL-2
AGCAGCCTCTCTTATG	PL-1
AGCAGCCTCTGGTATG	PL-vir1
AGCATACAGACCTAGG	PL-0
AGCATACAGAGACGAA	PL-Rel
AGCATACAGAGTACCG	PL-3
AGCATACAGATCCCGC	PL-Rel
AGCATACAGCTGCAAG	PL-1
AGCATACAGGTGCAAC	PL-0
AGCATACCAAACCTAC	PL-Rel
AGCATACCAGGTGCCT	PL-Rel
AGCATACCATCGGAAG	PL-0
AGCATACGTACGCTGC	PL-Rel
AGCATACGTAGGACAC	PL-2
AGCATACGTGGTGTAG	PL-Rel
AGCATACGTTGAGGTG	PL-0
AGCATACTCACCCGAG	PL-robo2
AGCATACTCTCGTATT	PL-0
AGCATACTCTGCGGCA	PL-3
AGCCTAAAGAATGTGT	PL-3
AGCCTAAAGACTCGGA	PL-robo2
AGCCTAAAGCTACCGC	PL-3
AGCCTAAAGGAATGGA	PL-1
AGCCTAAAGGTCATCT	PL-2
AGCCTAACAAAGGAAG	PL-Rel
AGCCTAACACCAGATT	PL-1
AGCCTAACACCAGTTA	PL-Pcd
AGCCTAACACGAGAGT	PL-vir1
AGCCTAACACGTCAGC	PL-0
AGCCTAACAGTCACTA	PL-1
AGCCTAAGTGGCGAAT	PL-1
AGCCTAAGTGTGAATA	PL-vir1
AGCCTAAGTTCAGTAC	PL-0
AGCCTAAGTTCCACAA	PL-1
AGCCTAATCAATAAGG	PL-0
AGCCTAATCACCGGGT	PL-Rel
AGCCTAATCCCTCAGT	PL-1
AGCGGTCAGAGGACGG	PL-Rel
AGCGGTCAGAGTACAT	PL-vir1
AGCGGTCAGTTTAGGA	PL-1
AGCGGTCCAAACTGCT	PL-2
AGCGGTCCAAGTCTGT	PL-Inos
AGCGGTCCAATTCCTT	PL-2
AGCGGTCCACGAAACG	PL-Rel
AGCGGTCCACGAAAGC	PL-2
AGCGGTCCAGCCTATA	PL-1
AGCGGTCGTCGCATAT	PL-3
AGCGGTCGTGAGTATA	PL-0
AGCGGTCGTGGACGAT	PL-0
AGCGGTCGTGTTTGTG	PL-0
AGCGGTCTCAATACCG	PL-robo2
AGCGGTCTCAGCATGT	PL-1
AGCGGTCTCATCGATG	PL-3
AGCGGTCTCCGCATAA	PL-1
AGCGGTCTCTACTCAT	PL-0
AGCGGTCTCTGGAGCC	PL-0
AGCGGTCTCTTGAGAC	PL-2
AGCGTATAGTCGCCGT	PL-1
AGCGTATCAAACGCGA	PL-0
AGCGTATCAAACGTGG	PL-Rel
AGCGTATCAAGTAATG	PL-2
AGCGTATCAATAACGA	PL-1
AGCGTATCACATTAGC	PL-2
AGCGTATCACCGTTGG	PL-2
AGCGTATCAGTAAGAT	PL-1
AGCGTATCATGACGGA	PL-0
AGCGTATCATGCCTAA	PL-3
AGCGTATGTCATGCAT	PL-0
AGCGTATGTTATGCGT	PL-robo2
AGCGTATTCGGTTCGG	PL-robo2
AGCGTATTCTCTGCTG	PL-Rel
AGCGTATTCTTAGCCC	PL-Inos
AGCGTCGAGCGCCTCA	PL-Rel
AGCGTCGCATAGTAAG	PL-0
AGCGTCGCATCAGTCA	PL-Inos
AGCGTCGGTATCAGTC	PL-0
AGCGTCGGTCCGTCAG	PL-2
AGCGTCGGTTAAGAAC	PL-0
AGCGTCGTCAACGCTA	PL-vir1
AGCGTCGTCAACTCTT	PL-robo2
AGCGTCGTCGGATGTT	PL-Lsp
AGCGTCGTCTCAAACG	PL-0
AGCGTCGTCTCCTATA	PL-0
AGCTCCTAGATACACA	PL-0
AGCTCCTAGCACCGTC	PL-robo2
AGCTCCTAGCGGATCA	PL-0
AGCTCCTAGCTGAACG	PL-Rel
AGCTCCTAGGGCTCTC	PL-2
AGCTCCTAGGGTGTTG	PL-vir1
AGCTCCTAGGTAGCTG	PL-1
AGCTCCTCAAACTGCT	PL-3
AGCTCCTCAATGGAGC	PL-Rel
AGCTCCTCATCTATGG	PL-3
AGCTCCTGTCTCCCTA	PL-3
AGCTCCTTCCATGAGT	PL-3
AGCTCCTTCCGCGTTT	PL-0
AGCTCCTTCCTGTAGA	PL-Pcd
AGCTCTCAGAAACGAG	PL-1
AGCTCTCAGCTAGTTC	PL-Rel
AGCTCTCAGCTCTCGG	PL-2
AGCTCTCAGGACAGCT	PL-1
AGCTCTCAGGCGTACA	PL-1
AGCTCTCAGTACCGGA	PL-Lsp
AGCTCTCAGTTACCCA	PL-Rel
AGCTCTCCACACAGAG	PL-robo2
AGCTCTCCACTTCGAA	PL-0
AGCTCTCCATTTCACT	PL-2
AGCTCTCGTCCGAAGA	PL-Inos
AGCTCTCGTCCTCCAT	PL-vir1
AGCTCTCGTCGCATCG	PL-Pcd
AGCTCTCGTCGCTTTC	PL-1
AGCTCTCGTTAAGGGC	PL-2
AGCTCTCTCAAACGGG	PL-0
AGCTCTCTCAGTCCCT	PL-1
AGCTCTCTCCACTCCA	PL-2
AGCTCTCTCGATCCCT	PL-0
AGCTCTCTCGCCATAA	PL-robo2
AGCTCTCTCGTCTGCT	PL-Rel
AGCTCTCTCTACCTGC	PL-Pcd
AGCTCTCTCTTTCCTC	PL-Rel
AGCTTGAAGCGGCTTC	PL-Rel
AGCTTGACACGAAGCA	PL-Pcd
AGCTTGACACTTAACG	PL-Pcd
AGCTTGACAGCATACT	PL-1
AGCTTGACAGCTCCGA	PL-3
AGCTTGACAGGACCCT	PL-2
AGCTTGACATACCATG	PL-Rel
AGCTTGAGTCCAGTGC	PL-0
AGCTTGAGTCTAGTGT	PL-0
AGCTTGAGTGATGCCC	PL-1
AGCTTGAGTGCAGGTA	PL-2
AGCTTGAGTGCGCTTG	PL-1
AGCTTGAGTTCCCTTG	PL-1
AGCTTGATCAGCACAT	PL-Pcd
AGCTTGATCCTTCAAT	PL-2
AGCTTGATCTTACCGC	PL-2
AGGCCACAGATGTGTA	PL-1
AGGCCACAGCTAACTC	PL-2
AGGCCACAGGGTTTCT	PL-3
AGGCCACAGGTGTGGT	PL-0
AGGCCACAGTCCAGGA	PL-0
AGGCCACAGTGCCATT	PL-1
AGGCCACCAACAACCT	PL-1
AGGCCACCAGCTGCTG	PL-1
AGGCCACCATCGACGC	PL-0
AGGCCACCATGGTTGT	PL-robo2
AGGCCACGTATATGGA	PL-1
AGGCCACGTCGGCATC	PL-vir1
AGGCCACGTCTAGCCG	PL-Lsp
AGGCCACTCCAGTATG	PL-Rel
AGGCCACTCTACTATC	PL-1
AGGCCGTAGCTGCCCA	PL-2
AGGCCGTCACAGATTC	PL-0
AGGCCGTCACTACAGT	PL-2
AGGCCGTCAGTCACTA	PL-0
AGGCCGTGTATATGGA	PL-0
AGGCCGTGTCGGCTCA	PL-robo2
AGGCCGTGTGAAGGCT	PL-3
AGGCCGTTCAACCAAC	PL-0
AGGCCGTTCATAACCG	PL-2
AGGCCGTTCGCATGAT	PL-Pcd
AGGCCGTTCGTCCAGG	PL-robo2
AGGCCGTTCTGGTGTA	PL-2
AGGGAGTAGACACTAA	PL-0
AGGGAGTAGACCCACC	PL-0
AGGGAGTAGGCAAAGA	PL-2
AGGGAGTAGGCAGTCA	PL-2
AGGGAGTAGGGATCTG	PL-0
AGGGAGTAGTAGGCCA	PL-Pcd
AGGGAGTAGTGAACGC	PL-2
AGGGAGTAGTTAGCGG	PL-1
AGGGAGTAGTTGCAGG	PL-Lsp
AGGGAGTCAAGACACG	PL-2
AGGGAGTCAAGTTAAG	PL-3
AGGGAGTCACCATCCT	PL-1
AGGGAGTCACGACTCG	PL-0
AGGGAGTCATTCTTAC	PL-1
AGGGAGTGTCATACTG	PL-1
AGGGAGTGTCGGGTCT	PL-Rel
AGGGAGTGTGAGGGTT	PL-0
AGGGAGTGTGGTGTAG	PL-0
AGGGAGTGTTCACCTC	PL-3
AGGGAGTTCACCATAG	PL-2
AGGGAGTTCGGCATCG	PL-3
AGGGAGTTCGTTACAG	PL-3
AGGGAGTTCTACCTGC	PL-2
AGGGATGAGACACTAA	PL-Rel
AGGGATGAGAGGTTAT	PL-Inos
AGGGATGAGATAGGAG	PL-2
AGGGATGAGCCTCGTG	PL-1
AGGGATGAGGGCTTCC	PL-robo2
AGGGATGAGTGGGCTA	PL-robo2
AGGGATGAGTTAGGTA	PL-0
AGGGATGAGTTGAGAT	PL-2
AGGGATGCATCCGGGT	PL-Rel
AGGGATGCATGAAGTA	PL-2
AGGGATGCATTTGCTT	PL-2
AGGGATGGTGACGGTA	CC
AGGGATGGTGCCTGGT	PL-3
AGGGATGGTGTGCGTC	PL-0
AGGGATGGTTCATGGT	PL-0
AGGGATGTCCAGAAGG	PL-1
AGGGATGTCCTGTAGA	PL-1
AGGGATGTCTGAGGGA	PL-0
AGGGTGAAGATCCTGT	PL-2
AGGGTGAAGGGCATGT	PL-0
AGGGTGAAGTGGACGT	PL-Rel
AGGGTGAAGTTTAGGA	PL-2
AGGGTGACAAATCCGT	PL-1
AGGGTGACACACAGAG	PL-Rel
AGGGTGACAGCGAACA	PL-1
AGGGTGAGTCATCGGC	PL-Rel
AGGGTGAGTTGGGACA	PL-0
AGGGTGATCATCTGTT	PL-3
AGGGTGATCCGGCACA	PL-Pcd
AGGGTGATCCTTAATC	PL-robo2
AGGGTGATCTAGAGTC	PL-Rel
AGGGTGATCTATCGCC	PL-Pcd
AGGTCATAGAGTACAT	PL-Pcd
AGGTCATAGGCACATG	PL-3
AGGTCATAGTGAACGC	PL-0
AGGTCATAGTGGGTTG	PL-0
AGGTCATAGTGTTAGA	PL-2
AGGTCATCAAAGTCAA	PL-0
AGGTCATCAATGCCAT	PL-0
AGGTCATCACATTCGA	PL-1
AGGTCATCACTACAGT	PL-0
AGGTCATCAGGTCTCG	PL-1
AGGTCATCATCTATGG	PL-1
AGGTCATGTAACGACG	PL-0
AGGTCATGTAAGTTCC	PL-robo2
AGGTCATGTTAAGTAG	PL-vir1
AGGTCATTCAAACGGG	PL-0
AGGTCATTCAGAGACG	CC
AGGTCATTCAGGCAAG	PL-vir1
AGGTCATTCATCTGTT	PL-Lsp
AGGTCATTCTACTCAT	PL-2
AGGTCATTCTGTTTGT	CC
AGGTCCGAGATGCGAC	PL-2
AGGTCCGAGGGCTTCC	PL-Rel
AGGTCCGCAACTGCTA	PL-Rel
AGGTCCGCAAGCGATG	PL-ImpL2
AGGTCCGCAAGTTAAG	PL-3
AGGTCCGCACGAAGCA	PL-0
AGGTCCGCAGTAAGAT	PL-robo2
AGGTCCGCAGTAGAGC	PL-Rel
AGGTCCGGTGCGGTAA	PL-Inos
AGGTCCGTCAGGATCT	PL-Inos
AGTAGTCAGCCCAACC	PL-2
AGTAGTCAGGAGTCTG	PL-AMP
AGTAGTCCAGCCTGTG	PL-1
AGTAGTCCAGGGCATA	PL-2
AGTAGTCCATCACCCT	PL-0
AGTAGTCGTAAGAGGA	PL-prolif
AGTAGTCGTCCTAGCG	PL-1
AGTAGTCGTCGACTAT	PL-1
AGTAGTCGTTGTCTTT	PL-1
AGTAGTCTCCAGTATG	PL-2
AGTAGTCTCTAAGCCA	PL-3
AGTAGTCTCTTGCATT	PL-0
AGTCTTTAGAGTAATC	PL-3
AGTCTTTAGGACACCA	PL-robo2
AGTCTTTAGTACGATA	PL-Rel
AGTCTTTCAAGCGTAG	PL-1
AGTCTTTCAATGCCAT	PL-2
AGTCTTTCACACAGAG	PL-0
AGTCTTTCAGACGTAG	PL-Rel
AGTCTTTCAGGATTGG	PL-1
AGTCTTTCAGTCAGCC	PL-3
AGTCTTTGTAGAGGAA	PL-Inos
AGTCTTTGTGAGTGAC	PL-2
AGTCTTTGTTACTGAC	PL-prolif
AGTGAGGAGAAGGCCT	PL-1
AGTGAGGAGAAGGTGA	PL-vir1
AGTGAGGAGAATCTCC	PL-3
AGTGAGGAGACCACGA	PL-Rel
AGTGAGGAGGAGTTGC	PL-3
AGTGAGGAGGCGACAT	PL-1
AGTGAGGAGTTCGATC	PL-Lsp
AGTGAGGCACTAGTAC	PL-2
AGTGAGGGTAACGTTC	PL-robo2
AGTGAGGGTAGCGCTC	PL-1
AGTGAGGGTCTAGAGG	PL-Rel
AGTGAGGGTCTTCTCG	PL-3
AGTGAGGGTTACTGAC	PL-Rel
AGTGAGGTCAAGATCC	PL-1
AGTGAGGTCCTCTAGC	PL-0
AGTGAGGTCGAACGGA	PL-0
AGTGAGGTCGACCAGC	PL-2
AGTGAGGTCTCTGTCG	PL-Rel
AGTGAGGTCTGGCGAC	PL-robo2
AGTGGGAAGCCAGTAG	PL-1
AGTGGGAAGCTTTGGT	PL-3
AGTGGGAAGTATCTCG	PL-2
AGTGGGAAGTGTTAGA	PL-robo2
AGTGGGACAAATACAG	PL-ImpL2
AGTGGGACACAAGCCC	PL-1
AGTGGGACACGGTTTA	PL-2
AGTGGGACAGGATCGA	PL-0
AGTGGGATCACCCTCA	PL-2
AGTGGGATCATCTGTT	PL-3
AGTGGGATCCTTAATC	PL-robo2
AGTGTCAAGGACAGAA	PL-0
AGTGTCAAGGACCACA	PL-1
AGTGTCAAGGTGCACA	PL-Rel
AGTGTCAAGGTTACCT	PL-0
AGTGTCACAAGTCTGT	PL-0
AGTGTCACACGGACAA	PL-3
AGTGTCACACGGCGTT	PL-2
AGTGTCACATCCGCGA	PL-2
AGTGTCACATGCCCGA	PL-1
AGTGTCAGTAGTAGTA	PL-1
AGTGTCAGTCATGCCG	PL-1
AGTGTCAGTCCAGTTA	PL-2
AGTGTCAGTGGGTCAA	PL-1
AGTGTCAGTTTAGGAA	PL-1
AGTGTCATCTTTAGGG	PL-1
AGTTGGTAGGCCCGTT	PL-2
AGTTGGTAGTACGTAA	PL-2
AGTTGGTCATCGGGTC	PL-2
AGTTGGTCATTATCTC	PL-Rel
AGTTGGTGTTGGAGGT	PL-0
AGTTGGTTCAATACCG	PL-Rel
AGTTGGTTCACGCGGT	PL-ImpL2
AGTTGGTTCAGCTCGG	PL-prolif
AGTTGGTTCCAATGGT	PL-Rel
AGTTGGTTCTCACATT	PL-0
AGTTGGTTCTCTTGAT	PL-3
AGTTGGTTCTGTCCGT	PL-2
ATAACGCAGCACCGTC	PL-Rel
ATAACGCAGCTTATCG	PL-1
ATAACGCAGTGTTAGA	PL-2
ATAACGCCAGACAGGT	PL-robo2
ATAACGCCATGGTAGG	PL-robo2
ATAACGCGTATAAACG	PL-2
ATAACGCGTCTAAAGA	PL-Rel
ATAACGCGTCTCCCTA	PL-2
ATAACGCGTCTGGAGA	PL-robo2
ATAACGCGTCTGGTCG	PL-Pcd
ATAACGCGTGACGCCT	PL-3
ATAACGCGTGCGAAAC	PL-2
ATAACGCGTGGTTTCA	PL-Rel
ATAACGCTCAACCAAC	PL-Rel
ATAACGCTCAGCATGT	PL-vir1
ATAACGCTCTGAGTGT	PL-prolif
ATAAGAGAGAATAGGG	PL-3
ATAAGAGAGATGGGTC	PL-Inos
ATAAGAGAGGGTGTTG	PL-1
ATAAGAGAGTGGCACA	PL-0
ATAAGAGAGTGTACTC	PL-3
ATAAGAGCAAAGGCGT	PL-Rel
ATAAGAGCAAAGTGCG	PL-0
ATAAGAGCACACTGCG	PL-Pcd
ATAAGAGCAGACAGGT	PL-2
ATAAGAGGTAAAGTCA	PL-1
ATAAGAGGTCGAGATG	PL-0
ATAAGAGGTGAGGCTA	PL-0
ATAAGAGGTGCGATAG	PL-1
ATAAGAGGTTACGGAG	PL-3
ATAAGAGTCAGAGCTT	PL-0
ATAAGAGTCATTATCC	PL-2
ATAGACCAGCCTTGAT	PL-Inos
ATAGACCAGCTAACTC	PL-1
ATAGACCAGCTCCTCT	PL-Pcd
ATAGACCAGTGGTCCC	PL-0
ATAGACCAGTTTGCGT	PL-Rel
ATAGACCCAAGACACG	PL-3
ATAGACCCAATGAAAC	PL-Inos
ATAGACCCATTGGTAC	PL-vir1
ATAGACCGTACCGCTG	PL-robo2
ATAGACCGTTATCCGA	PL-2
ATAGACCTCCAGTATG	PL-Pcd
ATAGACCTCCATGAAC	PL-2
ATAGACCTCCTAGTGA	PL-0
ATAGACCTCTATGTGG	PL-vir1
ATCACGAAGAAGGTGA	PL-2
ATCACGAAGCGATCCC	PL-Lsp
ATCACGAAGCGTTGCC	PL-Rel
ATCACGAAGGTAGCTG	PL-2
ATCACGAAGGTGGGTT	PL-vir1
ATCACGACAGATCTGT	PL-0
ATCACGACAGGTCTCG	PL-3
ATCACGACATAACCTG	PL-0
ATCACGACATAGGATA	PL-2
ATCACGACATTGTGCA	PL-0
ATCACGAGTCATATGC	PL-Lsp
ATCACGAGTCGCGTGT	PL-3
ATCACGAGTGCACGAA	PL-2
ATCACGATCATACGGT	PL-vir1
ATCACGATCCGTAGGC	PL-Rel
ATCACGATCTAAGCCA	PL-0
ATCATCTAGAACTCGG	PL-Pcd
ATCATCTAGAGCTGCA	PL-Rel
ATCATCTAGAGGTAGA	PL-0
ATCATCTAGCTGATAA	PL-3
ATCATCTAGGCCCGTT	PL-0
ATCATCTAGTTATCGC	PL-2
ATCATCTAGTTCGATC	PL-Pcd
ATCATCTCAACTTGAC	PL-Rel
ATCATCTCACCGAAAG	PL-2
ATCATCTCATGCTGGC	PL-Rel
ATCATCTGTACAGTGG	PL-3
ATCATCTGTCGCCATG	PL-1
ATCATCTGTGTAAGTA	PL-3
ATCATCTGTGTCGCTG	PL-0
ATCATCTGTTCCCTTG	PL-0
ATCATCTGTTCTGTTT	PL-vir1
ATCATCTTCAGCTCTC	PL-0
ATCATCTTCCGATATG	PL-0
ATCATCTTCTCTGTCG	PL-0
ATCATCTTCTGTCAAG	PL-3
ATCATCTTCTTTACAC	PL-2
ATCATGGAGAATCTCC	PL-0
ATCATGGAGACAATAC	PL-1
ATCATGGAGACCTAGG	PL-Inos
ATCATGGAGAGCTGCA	PL-2
ATCATGGAGAGTAATC	PL-2
ATCATGGAGCACCGTC	PL-0
ATCATGGAGCATGGCA	PL-2
ATCATGGAGCCACCTG	PL-vir1
ATCATGGAGCGCCTCA	PL-0
ATCATGGAGGACACCA	PL-Rel
ATCATGGCAGTGGAGT	PL-3
ATCATGGGTACCGAGA	PL-Inos
ATCATGGGTGATAAGT	PL-2
ATCATGGTCCCTAATT	PL-1
ATCATGGTCGCATGGC	PL-1
ATCATGGTCGGCTACG	PL-0
ATCATGGTCTCGAGTA	PL-Pcd
ATCATGGTCTGGTGTA	PL-Inos
ATCCACCAGAGCAATT	PL-3
ATCCACCAGATGTAAC	PL-0
ATCCACCAGGCATGGT	PL-Inos
ATCCACCAGTACGTAA	PL-AMP
ATCCACCAGTGCCAGA	PL-3
ATCCACCAGTGTTTGC	PL-0
ATCCACCCAATCCGAT	PL-Lsp
ATCCACCCAGATGAGC	PL-Inos
ATCCACCCATGGATGG	PL-robo2
ATCCACCGTATCACCA	PL-Rel
ATCCACCGTATCGCAT	PL-Rel
ATCCACCGTCATATGC	PL-robo2
ATCCACCGTCTTCAAG	PL-2
ATCCACCGTGACGCCT	PL-Rel
ATCCACCGTTACCGAT	PL-2
ATCCACCGTTCTGAAC	PL-vir1
ATCCACCTCAAGGTAA	PL-0
ATCCACCTCAGAAATG	PL-2
ATCCACCTCATCGATG	PL-2
ATCCACCTCCAGTAGT	PL-2
ATCCACCTCCGCGCAA	PL-robo2
ATCCACCTCGCAAGCC	PL-2
ATCCGAAAGAAGGTGA	PL-Rel
ATCCGAAAGACTAAGT	PL-vir1
ATCCGAAAGGCTCATT	PL-1
ATCCGAAAGTCAAGCG	PL-Pcd
ATCCGAACAAATCCGT	PL-1
ATCCGAACATGCAACT	PL-1
ATCCGAAGTATCTGCA	PL-0
ATCCGAAGTCCAGTAT	PL-2
ATCCGAAGTTACAGAA	PL-0
ATCCGAAGTTGCCTCT	PL-vir1
ATCCGAATCCGCGTTT	PL-0
ATCCGAATCCTCAATT	PL-0
ATCCGAATCTCTTATG	PL-1
ATCGAGTAGAAGATTC	PL-2
ATCGAGTAGATATACG	PL-0
ATCGAGTAGTCCCACG	PL-2
ATCGAGTAGTGTCCCG	PL-Inos
ATCGAGTGTGTGCCTG	PL-1
ATCGAGTTCACGATGT	PL-0
ATCGAGTTCCCATTTA	PL-robo2
ATCGAGTTCCCTAACC	PL-Rel
ATCGAGTTCCCTCAGT	PL-Rel
ATCGAGTTCGAACTGT	PL-1
ATCTACTAGAATGTGT	PL-vir1
ATCTACTAGGACATTA	PL-robo2
ATCTACTAGGGAGTAA	PL-1
ATCTACTAGGTGACCA	PL-Inos
ATCTACTAGGTTCCTA	PL-Rel
ATCTACTAGTCCGTAT	PL-2
ATCTACTCAGCCTATA	PL-Lsp
ATCTACTCAGGCTCAC	PL-1
ATCTACTCATCTACGA	PL-2
ATCTACTCATCTCCCA	PL-Pcd
ATCTACTCATGGTCTA	PL-0
ATCTACTGTACAGTTC	PL-robo2
ATCTACTGTAGCGTCC	PL-1
ATCTACTGTGACGCCT	PL-Pcd
ATCTACTGTGACTACT	PL-vir1
ATCTACTGTGCAACGA	PL-1
ATCTACTGTGCCTTGG	PL-Pcd
ATCTACTTCCCTCTTT	PL-2
ATCTACTTCTATCCCG	PL-0
ATCTGCCAGACCACGA	PL-1
ATCTGCCAGATCTGAA	PL-1
ATCTGCCAGCTAACAA	PL-0
ATCTGCCAGGACATTA	PL-0
ATCTGCCAGGCATTGG	PL-3
ATCTGCCAGTAGCGGT	PL-0
ATCTGCCAGTGGACGT	PL-0
ATCTGCCCACATAACC	PL-1
ATCTGCCCACATGTGT	PL-robo2
ATCTGCCCACGGTTTA	PL-0
ATCTGCCCAGGTGGAT	PL-vir1
ATCTGCCCATCGTCGG	PL-robo2
ATCTGCCCATTCTTAC	PL-Pcd
ATCTGCCGTAGCTAAA	PL-0
ATCTGCCGTCACTTCC	PL-2
ATCTGCCGTCTGCCAG	PL-vir1
ATCTGCCGTTCCACGG	PL-Rel
ATCTGCCGTTCCCGAG	PL-1
ATCTGCCTCAGAGGTG	PL-2
ATCTGCCTCAGCATGT	PL-1
ATCTGCCTCTCAAGTG	PL-Pcd
ATGAGGGAGAACTCGG	PL-1
ATGAGGGAGAAGCCCA	PL-Lsp
ATGAGGGAGATATGGT	PL-2
ATGAGGGAGATCCTGT	PL-0
ATGAGGGAGCCACGCT	PL-3
ATGAGGGAGGACATTA	PL-vir1
ATGAGGGAGGAGCGTT	PL-2
ATGAGGGAGTGAACAT	PL-1
ATGAGGGAGTGTACGG	PL-2
ATGAGGGCAAAGCGGT	PL-3
ATGAGGGCACCCAGTG	PL-3
ATGAGGGCACTGCCAG	PL-2
ATGAGGGCAGCTGCTG	PL-0
ATGAGGGCAGGGAGAG	PL-1
ATGAGGGCAGTGGAGT	PL-1
ATGAGGGGTAGAGTGC	PL-robo2
ATGAGGGGTCTCTTTA	PL-Rel
ATGAGGGGTGCCTGGT	PL-1
ATGAGGGGTGCGAAAC	PL-Rel
ATGAGGGTCAAGAAGT	PL-1
ATGAGGGTCCAAGCCG	PL-2
ATGAGGGTCCAGATCA	PL-0
ATGAGGGTCGGATGGA	PL-2
ATGAGGGTCTCGGACG	PL-2
ATGCGATAGAGGACGG	PL-vir1
ATGCGATAGTAGGCCA	PL-0
ATGCGATAGTATCTCG	PL-2
ATGCGATCAAAGTCAA	PL-0
ATGCGATCACTTACGA	PL-2
ATGCGATCAGCCTTTC	PL-1
ATGCGATCAGCTCGCA	PL-3
ATGCGATCATGAAGTA	PL-1
ATGCGATCATTAACCG	PL-Inos
ATGCGATGTAGCGTCC	PL-2
ATGCGATGTATTAGCC	PL-1
ATGCGATGTGAGCGAT	PL-Rel
ATGCGATGTGCAGTAG	PL-Rel
ATGCGATGTGTCCTCT	PL-2
ATGCGATGTGTTCTTT	PL-Inos
ATGCGATGTTGACGTT	PL-Rel
ATGCGATTCGAATGCT	PL-0
ATGCGATTCGTAGGTT	PL-1
ATGGGAGAGAGCTATA	PL-0
ATGGGAGAGGCATGGT	PL-Rel
ATGGGAGAGGTGATAT	PL-Pcd
ATGGGAGAGTCTTGCA	PL-3
ATGGGAGCACCGAAAG	PL-2
ATGGGAGCATACAGCT	PL-2
ATGGGAGGTCCGTGAC	PL-vir1
ATGGGAGGTCGAGATG	PL-Pcd
ATGGGAGGTCTAAAGA	PL-1
ATGGGAGGTCTAGTGT	PL-Rel
ATGGGAGGTCTGGAGA	PL-Lsp
ATGGGAGGTGGAAAGA	PL-1
ATGGGAGGTTCAGACT	PL-3
ATGGGAGTCGACAGCC	PL-0
ATGGGAGTCGGTTAAC	PL-0
ATGGGAGTCTGAGTGT	PL-1
ATGTGTGAGAAACCGC	PL-0
ATGTGTGAGACAGACC	PL-vir1
ATGTGTGAGCTCCTCT	PL-0
ATGTGTGAGCTGCCCA	PL-Pcd
ATGTGTGAGGAATTAC	PL-Rel
ATGTGTGAGGCGTACA	PL-0
ATGTGTGCAATGAAAC	PL-2
ATGTGTGCACGAGAGT	PL-Rel
ATGTGTGCAGCCTTTC	PL-2
ATGTGTGCATCACAAC	PL-3
ATGTGTGCATCTACGA	PL-3
ATGTGTGCATTTCACT	PL-1
ATGTGTGGTACCCAAT	PL-Inos
ATGTGTGGTACCGTAT	PL-0
ATGTGTGGTAGCGTAG	PL-2
ATGTGTGGTCCGAATT	PL-3
ATGTGTGGTTAAAGTG	PL-Inos
ATGTGTGGTTCGTCTC	PL-1
ATGTGTGTCAGCAACT	PL-2
ATGTGTGTCCTGCTTG	PL-0
ATTACTCAGATCCTGT	PL-3
ATTACTCAGGATCGCA	PL-0
ATTACTCAGGGCTTCC	PL-1
ATTACTCAGTCTCCTC	PL-prolif
ATTACTCCAGTATGCT	PL-1
ATTACTCCATAGACTC	PL-0
ATTACTCGTAAACCTC	PL-Lsp
ATTACTCGTCGTCTTC	PL-1
ATTACTCGTGAAATCA	PL-Rel
ATTACTCGTGCTGTAT	PL-vir1
ATTACTCGTTTGTTTC	PL-Rel
ATTACTCTCCAGGGCT	PL-0
ATTACTCTCCGCGCAA	PL-1
ATTACTCTCTTCGAGA	PL-robo2
ATTATCCAGCCACGTC	PL-3
ATTATCCAGGCTATCT	PL-robo2
ATTATCCCAGACAAGC	PL-robo2
ATTATCCCAGACAGGT	PL-1
ATTATCCCAGCTCGCA	PL-2
ATTATCCCATAGTAAG	PL-2
ATTATCCCATTCTTAC	PL-Rel
ATTATCCGTGTTGGGA	PL-1
ATTATCCTCAGTACGT	PL-2
ATTATCCTCTATGTGG	PL-1
ATTATCCTCTCGCATC	PL-1
ATTCTACAGACCACGA	PL-2
ATTCTACAGGCTCATT	PL-2
ATTCTACAGTGTGAAT	PL-2
ATTCTACCACACATGT	PL-3
ATTCTACCACAGGTTT	PL-2
ATTCTACCACGTAAGG	PL-1
ATTCTACCACGTTGGC	PL-0
ATTCTACCAGCGTTCG	PL-0
ATTCTACCATCAGTCA	PL-2
ATTCTACCATTGTGCA	PL-robo2
ATTCTACGTCTTCTCG	PL-1
ATTCTACGTCTTGTCC	PL-Pcd
ATTCTACGTTAGAACA	PL-2
ATTCTACTCATTGCGA	PL-2
ATTCTACTCTACGAGT	PL-0
ATTCTACTCTTGAGAC	PL-Rel
ATTGGACAGGTAAACT	PL-1
ATTGGACCAAGGACTG	PL-Rel
ATTGGACCAATCACAC	PL-Pcd
ATTGGACCAATGGAAT	PL-2
ATTGGACCACACATGT	PL-Rel
ATTGGACCACGAAATA	PL-Pcd
ATTGGACCAGACAAGC	PL-2
ATTGGACGTAGCCTAT	PL-2
ATTGGACGTATAGGGC	PL-2
ATTGGACGTATTAGCC	PL-1
ATTGGACGTCCCTTGT	PL-1
ATTGGACGTCCTCCAT	PL-0
ATTGGACGTCTAAAGA	PL-Rel
ATTGGACGTCTCTCTG	PL-0
ATTGGACGTGACGCCT	PL-3
ATTGGACGTGTGCGTC	PL-2
ATTGGACGTTCCCTTG	PL-2
ATTGGACGTTGTCTTT	PL-0
ATTGGACTCACCATAG	PL-1
ATTGGACTCGCCTGAG	PL-Lsp
ATTGGACTCGGATGGA	PL-2
ATTGGACTCTACCTGC	PL-robo2
ATTGGACTCTGTTTGT	PL-Pcd
ATTGGACTCTTGTCAT	PL-vir1
ATTGGTGAGCGATGAC	PL-Rel
ATTGGTGAGCGGATCA	PL-robo2
ATTGGTGAGCGTAATA	PL-2
ATTGGTGCAGACTCGC	PL-2
ATTGGTGCATCGATTG	PL-prolif
ATTGGTGGTAAGTGGC	PL-0
ATTGGTGGTGTCCTCT	PL-3
ATTGGTGGTTCCACAA	PL-0
ATTGGTGGTTTAAGCC	PL-robo2
ATTGGTGTCCGATATG	PL-1
ATTGGTGTCTATCGCC	PL-1
ATTGGTGTCTCGATGA	PL-vir1
ATTTCTGAGAACAATC	PL-prolif
ATTTCTGAGATCCCGC	PL-0
ATTTCTGAGATGCCTT	PL-3
ATTTCTGAGGTACTCT	PL-robo2
ATTTCTGCAAGAAGAG	PL-1
ATTTCTGCAATGGAAT	PL-robo2
ATTTCTGCAATGGACG	PL-3
ATTTCTGCATCGGACC	PL-1
ATTTCTGGTACATCCA	PL-2
ATTTCTGGTCCCGACA	PL-0
ATTTCTGGTCGAGTTT	PL-2
ATTTCTGGTGATGATA	PL-robo2
ATTTCTGGTGCACGAA	PL-3
ATTTCTGTCACGACTA	PL-1
ATTTCTGTCAGCATGT	PL-2
ATTTCTGTCCAGTAGT	PL-Pcd
ATTTCTGTCCCACTTG	PL-1
ATTTCTGTCTAACGGT	PL-Rel
ATTTCTGTCTGCGACG	PL-2
CAACCAAAGACACTAA	PL-0
CAACCAAAGAGTCGGT	PL-1
CAACCAAAGATGCCTT	PL-Rel
CAACCAACAAAGTCAA	PL-2
CAACCAACAATGAAAC	PL-0
CAACCAACAGGGAGAG	PL-2
CAACCAACAGTCGTGC	PL-0
CAACCAACATGTTCCC	PL-0
CAACCAACATTGAGCT	PL-1
CAACCAAGTAAGGGCT	PL-0
CAACCAAGTCGGATCC	PL-Pcd
CAACCAAGTCTGCAAT	PL-0
CAACCAAGTTCCGTCT	PL-0
CAACCAATCACGCGGT	PL-0
CAACCTCAGAATGTTG	PL-3
CAACCTCAGAGTGAGA	PL-2
CAACCTCAGCTGCGAA	PL-Rel
CAACCTCAGGCTAGAC	PL-Rel
CAACCTCAGTTCGCAT	PL-1
CAACCTCCACCGAAAG	PL-1
CAACCTCCAGGGATTG	PL-Rel
CAACCTCGTCGGCACT	PL-ImpL2
CAACCTCGTCGTGGCT	PL-2
CAACCTCGTCTCCATC	PL-Rel
CAACCTCGTCTCTTTA	PL-0
CAACCTCGTGCCTGTG	PL-2
CAACCTCGTTACTGAC	PL-Pcd
CAACCTCGTTGGAGGT	PL-0
CAACCTCTCATGGTCA	PL-0
CAACCTCTCCGAATGT	PL-1
CAACCTCTCCTAGAAC	PL-2
CAACCTCTCGGTGTCG	PL-1
CAACTAGAGGGAACGG	PL-1
CAACTAGAGGTGGGTT	PL-2
CAACTAGCACAAGTAA	PL-0
CAACTAGCACACCGCA	PL-2
CAACTAGCACAGAGGT	PL-1
CAACTAGCACAGGTTT	PL-2
CAACTAGCAGTGGAGT	PL-Rel
CAACTAGCATCGATGT	PL-1
CAACTAGCATCGGTTA	PL-2
CAACTAGCATTCCTGC	PL-1
CAACTAGGTAAGTGTA	PL-0
CAACTAGGTAGAGGAA	PL-robo2
CAACTAGGTAGCGATG	PL-3
CAACTAGGTCCGAACC	PL-Lsp
CAACTAGGTTACCGAT	PL-Pcd
CAACTAGGTTATCACG	PL-3
CAACTAGTCAGAGCTT	PL-2
CAACTAGTCATCTGTT	PL-Rel
CAACTAGTCGAACGGA	PL-3
CAACTAGTCGGCGCAT	PL-1
CAACTAGTCGTCTGAA	PL-Rel
CAACTAGTCTTACCTA	PL-vir1
CAAGAAAAGAAGGCCT	PL-1
CAAGAAAAGAGGTTAT	PL-2
CAAGAAAAGATAGTCA	PL-robo2
CAAGAAAAGCTGCAAG	PL-Rel
CAAGAAAAGTAACCCT	PL-2
CAAGAAAAGTGTACTC	PL-0
CAAGAAAGTACAGACG	PL-1
CAAGAAAGTATTACCG	PL-robo2
CAAGAAAGTATTCGTG	PL-1
CAAGAAAGTCTAGAGG	PL-2
CAAGAAAGTGAACCTT	PL-Rel
CAAGAAAGTGATGTGG	PL-Pcd
CAAGAAAGTGTTAAGA	PL-1
CAAGAAAGTTCGAATC	PL-2
CAAGAAATCCCTCTTT	PL-vir1
CAAGAAATCGATGAGG	PL-1
CAAGATCAGAAACGAG	PL-2
CAAGATCAGAAACGCC	PL-1
CAAGATCAGATGTTAG	PL-3
CAAGATCAGCAGGTCA	PL-Pcd
CAAGATCAGGGATACC	PL-robo2
CAAGATCAGTGTCTCA	PL-0
CAAGATCAGTTTCCTT	PL-0
CAAGATCCAAGCTGAG	PL-1
CAAGATCCACCAGATT	PL-2
CAAGATCCAGTGGGAT	PL-Rel
CAAGATCGTCACACGC	PL-Rel
CAAGATCGTGAGGCTA	PL-1
CAAGATCGTGGCCCTA	PL-AMP
CAAGATCTCCAAGCCG	PL-0
CAAGATCTCCTCAACC	PL-0
CAAGATCTCCTTGCCA	PL-Rel
CAAGATCTCGTTACGA	PL-1
CAAGATCTCTGAGTGT	PL-1
CAAGATCTCTTGCCGT	PL-2
CAAGGCCAGCCACGTC	PL-3
CAAGGCCAGCCCAGCT	PL-2
CAAGGCCAGCTCCTCT	PL-1
CAAGGCCAGGAGCGAG	PL-Inos
CAAGGCCAGGGTCTCC	PL-2
CAAGGCCAGTCGATAA	PL-Rel
CAAGGCCAGTTAGGTA	PL-3
CAAGGCCCAAACTGCT	PL-3
CAAGGCCCAGTCGATT	PL-Rel
CAAGGCCGTACTCTCC	PL-2
CAAGGCCGTAGGGACT	PL-Pcd
CAAGGCCGTCGCCATG	PL-3
CAAGGCCGTTTGACTG	PL-2
CAAGGCCTCACCGTAA	PL-1
CAAGGCCTCCCGACTT	PL-robo2
CAAGGCCTCCGAAGAG	PL-Rel
CAAGGCCTCCGAATGT	PL-0
CAAGGCCTCCTAGGGC	PL-vir1
CAAGGCCTCTGTCCGT	PL-2
CAAGTTGAGGATGGAA	PL-3
CAAGTTGAGGGCACTA	PL-3
CAAGTTGAGGTTCCTA	PL-2
CAAGTTGCACTCTGTC	PL-Rel
CAAGTTGCACTGAAGG	PL-3
CAAGTTGCAGCCTTTC	PL-3
CAAGTTGCATGTTGAC	PL-Rel
CAAGTTGCATTCCTCG	PL-Pcd
CAAGTTGGTACCGTTA	PL-0
CAAGTTGGTCTCAACA	PL-3
CAAGTTGGTGGTCCGT	PL-2
CAAGTTGGTTACTGAC	PL-0
CAAGTTGGTTGCTCCT	PL-3
CAAGTTGTCGAGAGCA	PL-Rel
CAAGTTGTCGCCCTTA	PL-0
CAAGTTGTCGTAGGTT	PL-0
CAAGTTGTCGTCCGTT	PL-AMP
CACAAACAGAAGGTGA	PL-Pcd
CACAAACAGATCTGCT	PL-1
CACAAACAGCATGGCA	PL-Inos
CACAAACAGCTGAAAT	PL-Inos
CACAAACAGTCGTTTG	PL-0
CACAAACCAACTGCGC	PL-1
CACAAACCAAGCCGCT	PL-2
CACAAACCAAGCGAGT	PL-Rel
CACAAACCAAGCTGTT	PL-robo2
CACAAACCACATAACC	PL-Rel
CACAAACCACGAAATA	PL-2
CACAAACCAGTCAGCC	PL-1
CACAAACGTAAATACG	PL-1
CACAAACGTAGATTAG	PL-0
CACAAACGTAGTGAAT	PL-1
CACAAACGTCTCGTTC	PL-2
CACAAACGTGGTCTCG	PL-0
CACAAACGTTGTCGCG	PL-Pcd
CACAAACGTTTACTCT	PL-Rel
CACAAACTCACGCATA	PL-2
CACAAACTCATACGGT	PL-ImpL2
CACAAACTCATGCATG	PL-3
CACAAACTCGGAGGTA	PL-3
CACAAACTCTAAGCCA	PL-robo2
CACACAAAGAACTCGG	PL-0
CACACAAAGGCATGTG	PL-2
CACACAAAGGTGATAT	PL-0
CACACAACAATTCCTT	PL-1
CACACAACAGGTCTCG	PL-1
CACACAACATCCTTGC	PL-2
CACACAAGTAAGGGCT	PL-Rel
CACACAAGTACCGGCT	PL-Rel
CACACAAGTGTTAAGA	PL-Rel
CACACAAGTTCGAATC	PL-0
CACACAAGTTTGACAC	PL-0
CACACAATCCTCCTAG	PL-Rel
CACACAATCCTGTAGA	PL-1
CACACAATCTAACCGA	PL-3
CACACCTAGAAGGGTA	PL-2
CACACCTAGACATAAC	PL-3
CACACCTAGACGCAAC	PL-Rel
CACACCTAGATAGTCA	PL-0
CACACCTAGATATACG	PL-2
CACACCTAGCGTGTCC	PL-0
CACACCTAGCTAACTC	PL-Lsp
CACACCTAGGTGTGGT	PL-Rel
CACACCTCAACGATGG	PL-robo2
CACACCTCAAGTTCTG	PL-Rel
CACACCTCACGGTAGA	PL-Rel
CACACCTCAGTGGAGT	PL-Pcd
CACACCTCATCAGTCA	PL-2
CACACCTCATTCTTAC	PL-Rel
CACACCTCATTTCACT	PL-3
CACACCTGTAGCGTCC	PL-Pcd
CACACCTGTAGTGAAT	PL-0
CACACCTGTCCCTTGT	PL-3
CACACCTGTCGCGGTT	PL-1
CACACCTGTCGTTGTA	PL-2
CACACCTTCGGTGTTA	PL-2
CACACTCAGACAGAGA	PL-2
CACACTCAGAGCTATA	PL-Rel
CACACTCAGATGGGTC	PL-1
CACACTCAGTCATGCT	PL-2
CACACTCCACCAGGCT	PL-Inos
CACACTCCACCAGTTA	PL-Rel
CACACTCGTACAGCAG	PL-0
CACACTCGTGATGATA	PL-robo2
CACACTCTCACCATAG	CC
CACACTCTCATTATCC	PL-1
CACACTCTCCAGTAGT	PL-robo2
CACACTCTCTCCCTGA	PL-1
CACACTCTCTTTACGT	PL-2
CACAGGCAGAATGTGT	PL-Pcd
CACAGGCAGCGATATA	PL-3
CACAGGCAGCTAACAA	PL-1
CACAGGCAGGACTGGT	PL-2
CACAGGCAGGGCTTCC	PL-robo2
CACAGGCAGTTCGCGC	PL-0
CACAGGCCACAGGTTT	PL-1
CACAGGCGTAACGCGA	PL-robo2
CACAGGCGTAGCGCAA	PL-0
CACAGGCGTGGGTATG	PL-Inos
CACAGGCTCAAGGTAA	PL-2
CACAGGCTCCGTTGTC	PL-0
CACAGGCTCCTTTCTC	PL-Rel
CACAGGCTCGGCTTGG	PL-0
CACAGTAAGACCCACC	PL-vir1
CACAGTAAGATGGGTC	PL-0
CACAGTAAGCCGGTAA	PL-0
CACAGTAAGTGGGCTA	PL-0
CACAGTAGTATAATGG	PL-Lsp
CACAGTAGTCATACTG	PL-Rel
CACAGTAGTCTAAAGA	PL-2
CACAGTAGTGCAGACA	PL-Rel
CACAGTAGTTGTGGCC	PL-Rel
CACAGTATCTAACTTC	PL-0
CACAGTATCTATGTGG	PL-Pcd
CACAGTATCTGGCGTG	PL-0
CACATAGAGATCCCGC	PL-2
CACATAGAGGCTCTTA	PL-vir1
CACATAGAGGGCTTGA	PL-0
CACATAGAGTGTACTC	PL-2
CACATAGCAACTGGCC	LM-1
CACATAGCAGTAACGG	PL-2
CACATAGCATCGGGTC	PL-2
CACATAGCATCTACGA	PL-vir1
CACATAGGTTTAGCTG	PL-1
CACATAGTCATAGCAC	PL-1
CACATAGTCCGTCAAA	PL-0
CACATTTAGCCATCGC	PL-robo2
CACATTTAGGGAACGG	PL-robo2
CACATTTAGTGCAAGC	PL-3
CACATTTAGTTGAGAT	PL-1
CACATTTCAAGCTGAG	PL-robo2
CACATTTCAGGTCTCG	PL-robo2
CACATTTCATGAACCT	PL-0
CACATTTGTACCGCTG	PL-vir1
CACATTTGTACTTGAC	PL-1
CACATTTGTCCTAGCG	PL-Lsp
CACATTTGTCTAGGTT	PL-Pcd
CACATTTGTCTGCGGT	PL-1
CACATTTGTGTATGGG	PL-vir1
CACATTTGTGTGTGCC	PL-robo2
CACATTTTCACCACCT	PL-robo2
CACATTTTCAGGCCCA	PL-2
CACATTTTCGTATCAG	PL-1
CACATTTTCTCAAGTG	PL-0
CACCACTAGAAGCCCA	PL-Rel
CACCACTAGAATAGGG	PL-0
CACCACTAGACACGAC	PL-vir1
CACCACTAGACTGTAA	PL-0
CACCACTAGCCCAACC	PL-robo2
CACCACTAGGATGTAT	PL-0
CACCACTCAAGCTGAG	PL-0
CACCACTCACAGACAG	PL-3
CACCACTCACAGCGTC	PL-robo2
CACCACTGTAGCGCAA	PL-3
CACCACTGTATTACCG	PL-2
CACCACTGTCGACTGC	PL-prolif
CACCACTGTTAAGACA	PL-1
CACCACTTCACAATGC	PL-2
CACCACTTCGTCGTTC	PL-Rel
CACCACTTCGTTACAG	PL-robo2
CACCACTTCTGTCTCG	PL-3
CACCACTTCTTGTATC	PL-1
CACCAGGAGAAACGCC	PL-2
CACCAGGAGACATAAC	PL-robo2
CACCAGGAGACTAGGC	PL-3
CACCAGGAGAGGTAGA	PL-1
CACCAGGAGCCACTAT	PL-1
CACCAGGAGCCCAACC	PL-2
CACCAGGAGCTGAAAT	PL-1
CACCAGGAGGATGTAT	PL-ImpL2
CACCAGGCAATAGCAA	PL-Rel
CACCAGGCAATCCAAC	PL-1
CACCAGGCACAAGCCC	PL-0
CACCAGGCACGGACAA	PL-1
CACCAGGCAGCTTAAC	PL-Rel
CACCAGGCATGGAATA	PL-robo2
CACCAGGCATTTGCCC	PL-0
CACCAGGGTAGCGTGA	PL-0
CACCAGGGTCTTGATG	PL-0
CACCAGGTCCTACAGA	PL-0
CACCAGGTCGATGAGG	PL-2
CACCAGGTCTTTAGTC	PL-Pcd
CACCTTGAGATCCGAG	PL-0
CACCTTGAGATTACCC	PL-0
CACCTTGAGCGCCTTG	PL-1
CACCTTGAGCGTTTAC	PL-0
CACCTTGAGTCATGCT	PL-3
CACCTTGAGTGAAGTT	PL-0
CACCTTGCAAACTGTC	PL-2
CACCTTGCAAGGGTCA	PL-prolif
CACCTTGCAATAGCAA	PL-2
CACCTTGCACTCGACG	PL-robo2
CACCTTGCAGCGTTCG	PL-Inos
CACCTTGCAGTATCTG	PL-Rel
CACCTTGCAGTGGGAT	PL-1
CACCTTGGTACAGCAG	PL-2
CACCTTGGTAGAAGGA	PL-Rel
CACCTTGGTGTGGTTT	PL-0
CACCTTGGTTCGCTAA	PL-0
CACCTTGTCATGGTCA	PL-Rel
CACCTTGTCCGATATG	PL-0
CACCTTGTCTCTTATG	PL-Rel
CACCTTGTCTGGTATG	PL-Rel
CACTCCAAGAGCCTAG	PL-Rel
CACTCCAAGATCCCAT	PL-Rel
CACTCCAAGGCCGAAT	PL-0
CACTCCAAGTGTGAAT	PL-0
CACTCCACAGTAAGAT	PL-Lsp
CACTCCAGTAAGTGGC	PL-2
CACTCCAGTAGGGTAC	PL-1
CACTCCAGTATATGAG	PL-Rel
CACTCCAGTTGTCTTT	PL-2
CACTCCATCCAGTATG	PL-1
CACTCCATCCCATTTA	PL-2
CACTCCATCGGGAGTA	PL-1
CACTCCATCGTCGTTC	PL-3
CACTCCATCTGTACGA	LM-1
CACTCCATCTGTCCGT	PL-0
CACTCCATCTTCGAGA	PL-Rel
CAGAATCAGAGGGCTT	PL-1
CAGAATCAGATCCTGT	PL-1
CAGAATCAGCCACTAT	PL-Pcd
CAGAATCAGGAGCGAG	PL-2
CAGAATCCATGACGGA	PL-2
CAGAATCGTAGGGACT	PL-1
CAGAATCGTCACTGGC	PL-vir1
CAGAATCGTGAACCTT	PL-0
CAGAATCGTTACGCGC	PL-0
CAGAATCTCCGCGGTA	PL-0
CAGAATCTCTCATTCA	PL-robo2
CAGAGAGAGCTCCTTC	PL-robo2
CAGAGAGAGTACCGGA	PL-Rel
CAGAGAGAGTGGTAGC	PL-0
CAGAGAGCAAGAGTCG	PL-robo2
CAGAGAGCACAGTCGC	PL-3
CAGAGAGCACGACTCG	PL-0
CAGAGAGCATCGGTTA	PL-2
CAGAGAGGTATAATGG	PL-0
CAGAGAGGTATTAGCC	PL-Rel
CAGAGAGGTCACCCAG	PL-1
CAGAGAGGTCCGAAGA	PL-0
CAGAGAGGTGTGAATA	PL-Lsp
CAGAGAGGTGTTTGGT	PL-1
CAGAGAGGTTATGTGC	PL-0
CAGAGAGTCAGCGATT	PL-2
CAGAGAGTCTTCGAGA	PL-robo2
CAGATCAAGGGCTCTC	PL-0
CAGATCAAGGGTCTCC	PL-AMP
CAGATCAAGGTGCTTT	PL-0
CAGATCAAGTGTGAAT	PL-Rel
CAGATCACACCTTGTC	PL-Rel
CAGATCACAGATGGGT	PL-2
CAGATCACATTGGTAC	PL-1
CAGATCAGTACCTACA	PL-Pcd
CAGATCAGTATTCGTG	PL-0
CAGATCAGTTAAGGGC	PL-0
CAGATCATCACATAGC	PL-Lsp
CAGATCATCATAAAGG	PL-2
CAGATCATCCTCTAGC	PL-1
CAGATCATCCTTGCCA	PL-2
CAGATCATCTCTTATG	PL-Rel
CAGCAGCAGAAGAAGC	PL-robo2
CAGCAGCAGCCAGTTT	PL-2
CAGCAGCAGCGTGAAC	PL-0
CAGCAGCAGGCAAAGA	PL-1
CAGCAGCCAACTGCTA	PL-0
CAGCAGCCAATCACAC	PL-0
CAGCAGCCACCTCGTT	PL-2
CAGCAGCCACTTGGAT	PL-1
CAGCAGCCATCACGAT	PL-1
CAGCAGCCATCACGTA	PL-1
CAGCAGCCATCATCCC	PL-1
CAGCAGCGTACCGGCT	PL-prolif
CAGCAGCGTATGAATG	PL-3
CAGCAGCGTGTTCGAT	PL-1
CAGCAGCGTGTTTGGT	PL-Inos
CAGCAGCTCCAGATCA	PL-0
CAGCAGCTCTCTTGAT	PL-0
CAGCATAAGAAACGAG	PL-3
CAGCATAAGATAGTCA	PL-1
CAGCATAAGCGTGTCC	PL-3
CAGCATAAGTGACTCT	PL-0
CAGCATACAATCGAAA	PL-0
CAGCATACAATGCCAT	PL-robo2
CAGCATACACCATCCT	PL-2
CAGCATACACCTCGGA	PL-Pcd
CAGCATACAGGCGATA	PL-3
CAGCATACATGCAATC	PL-1
CAGCATAGTCAAACTC	PL-2
CAGCATAGTCTACCTC	PL-robo2
CAGCATAGTGTTGGGA	PL-robo2
CAGCATATCCGTCATC	PL-vir1
CAGCCGAAGATGGGTC	PL-3
CAGCCGAAGCAATCTC	PL-1
CAGCCGAAGGACACCA	PL-robo2
CAGCCGACAGATCCAT	PL-0
CAGCCGAGTACCTACA	PL-2
CAGCCGAGTCCAGTGC	PL-2
CAGCCGAGTGACTCAT	PL-0
CAGCCGAGTGCATCTA	PL-Pcd
CAGCCGAGTTATGCGT	PL-2
CAGCCGATCACCGGGT	PL-Rel
CAGCCGATCCAAATGC	PL-Rel
CAGCCGATCGGTCTAA	PL-2
CAGCCGATCTCTGAGA	PL-3
CAGCGACAGCAATATG	PL-3
CAGCGACAGCCACTAT	PL-0
CAGCGACAGCCCGAAA	PL-0
CAGCGACAGGACATTA	PL-1
CAGCGACAGGATGCGT	PL-1
CAGCGACCAAACTGTC	PL-1
CAGCGACCACAGGAGT	PL-3
CAGCGACCACCGAAAG	PL-3
CAGCGACCATCGGACC	PL-2
CAGCGACGTAACGACG	PL-Pcd
CAGCGACGTCATGCCG	PL-2
CAGCGACGTCGACTAT	PL-Pcd
CAGCGACGTCGTGGCT	PL-vir1
CAGCGACTCCCGGATG	PL-3
CAGCGACTCCGCGTTT	PL-0
CAGCGACTCGGACAAG	PL-Pcd
CAGCTAAAGAAGGTTT	PL-Pcd
CAGCTAAAGCAGACTG	PL-3
CAGCTAAAGGCTAGAC	PL-Rel
CAGCTAACAAACCTAC	PL-0
CAGCTAACAAAGTCAA	PL-3
CAGCTAACACATCTTT	PL-0
CAGCTAACATAAGACA	PL-0
CAGCTAACATATGAGA	PL-1
CAGCTAACATGCAACT	PL-0
CAGCTAAGTAAACGCG	PL-vir1
CAGCTAATCCCATTAT	PL-Rel
CAGCTAATCCCATTTA	PL-2
CAGCTAATCCGCTGTT	PL-Pcd
CAGCTAATCCTAAGTG	PL-1
CAGCTAATCTTCGAGA	PL-2
CAGCTGGCAAATCCGT	PL-0
CAGCTGGCAATACGCT	PL-1
CAGCTGGCACGACGAA	PL-0
CAGCTGGCACTGTCGG	PL-1
CAGCTGGCAGGATTGG	PL-2
CAGCTGGCATAGGATA	PL-0
CAGCTGGCATTTCACT	PL-Rel
CAGCTGGGTCACCCAG	PL-2
CAGCTGGGTCGTCTTC	PL-0
CAGCTGGGTGGACGAT	PL-1
CAGCTGGGTTACGACT	PL-0
CAGCTGGGTTGCGTTA	PL-Pcd
CAGCTGGGTTGGAGGT	PL-1
CAGCTGGTCATCGCTC	PL-0
CAGCTGGTCATGCATG	PL-Pcd
CAGGTGCAGAAGAAGC	PL-0
CAGGTGCAGCCAGAAC	PL-2
CAGGTGCAGCGTAGTG	PL-vir1
CAGGTGCAGTACCGGA	PL-2
CAGGTGCAGTGGTCCC	PL-3
CAGGTGCAGTGTACGG	PL-vir1
CAGGTGCCACATGACT	PL-0
CAGGTGCCATCAGTAC	PL-2
CAGGTGCCATCTACGA	PL-Lsp
CAGGTGCGTCCCTTGT	PL-robo2
CAGGTGCGTCTAGAGG	PL-2
CAGGTGCGTCTAGTCA	PL-3
CAGGTGCGTGCCTGTG	PL-robo2
CAGGTGCGTGTAATGA	PL-1
CAGGTGCTCGCGGATC	PL-0
CAGGTGCTCTATCCTA	PL-Rel
CAGTAACAGGCTAGAC	PL-vir1
CAGTAACCAATGGAAT	PL-3
CAGTAACCACAGACAG	PL-0
CAGTAACCACGCATCG	PL-2
CAGTAACCAGACTCGC	PL-Pcd
CAGTAACCAGCCTATA	PL-3
CAGTAACCATCACAAC	PL-AMP
CAGTAACCATCCAACA	PL-1
CAGTAACCATGAGCGA	PL-Lsp
CAGTAACGTCAACTGT	PL-2
CAGTAACTCAACACGT	PL-2
CAGTAACTCATATCGG	PL-3
CAGTAACTCATGTAGC	PL-3
CAGTAACTCATGTCCC	PL-2
CAGTAACTCCCTCAGT	PL-1
CAGTCCTAGAGCTGGT	PL-robo2
CAGTCCTAGATCCTGT	PL-0
CAGTCCTAGTGAACGC	PL-2
CAGTCCTCACTCGACG	PL-Rel
CAGTCCTCACTGAAGG	PL-1
CAGTCCTCAGCTCCGA	PL-2
CAGTCCTCAGTAGAGC	PL-1
CAGTCCTCATGCTGGC	PL-Lsp
CAGTCCTGTAGGGTAC	PL-Rel
CAGTCCTGTATAGGGC	PL-2
CAGTCCTGTATAGTAG	PL-2
CAGTCCTGTCACTGGC	PL-1
CAGTCCTGTGATAAGT	PL-1
CAGTCCTTCGACCAGC	PL-Rel
CAGTCCTTCTGACCTC	PL-2
CATATGGAGAAACGCC	PL-0
CATATGGAGCGACGTA	PL-Rel
CATATGGAGTAGCCGA	PL-0
CATATGGAGTCTCCTC	PL-Rel
CATATGGAGTTAACGA	PL-robo2
CATATGGCAACTTGAC	PL-1
CATATGGCAAGCGAGT	PL-2
CATATGGCACGGTAGA	PL-3
CATATGGCAGCCTATA	PL-3
CATATGGGTACCGAGA	PL-3
CATATGGGTGGTTTCA	PL-2
CATATGGTCATGCAAC	PL-2
CATATTCAGATGTGGC	PL-1
CATATTCAGGCTAGAC	PL-2
CATATTCAGGTTACCT	PL-robo2
CATATTCCAACTTGAC	PL-robo2
CATATTCCACACGCTG	PL-3
CATATTCCACAGACTT	PL-2
CATATTCCAGACAAGC	PL-3
CATATTCCATGAAGTA	PL-2
CATATTCGTACATGTC	PL-Rel
CATATTCGTACCCAAT	PL-Pcd
CATATTCGTGAGGGTT	PL-Rel
CATATTCGTTACGTCA	PL-1
CATATTCGTTCACGGC	PL-0
CATATTCTCAACACTG	PL-robo2
CATATTCTCAGAGGTG	PL-1
CATATTCTCCTAGAAC	PL-Pcd
CATATTCTCGTCTGCT	PL-vir1
CATCAAGAGAAGCCCA	PL-2
CATCAAGAGACTTGAA	PL-1
CATCAAGAGGAGCGAG	PL-0
CATCAAGAGTCCCACG	PL-1
CATCAAGAGTCCGGTC	PL-2
CATCAAGAGTCGCCGT	PL-0
CATCAAGAGTTAGGTA	PL-2
CATCAAGCACGTTGGC	PL-0
CATCAAGCACTTCGAA	PL-1
CATCAAGCAGGCGATA	PL-Rel
CATCAAGCAGGGTATG	PL-1
CATCAAGCATCGTCGG	CC
CATCAAGCATTAGCCA	PL-2
CATCAAGTCACTTCAT	PL-2
CATCAAGTCCAAACAC	PL-Rel
CATCAAGTCCTGCCAT	PL-3
CATCAGAAGCCACCTG	PL-Rel
CATCAGAAGCGGATCA	PL-Rel
CATCAGAAGGACGAAA	PL-Lsp
CATCAGAAGGTGACCA	PL-Rel
CATCAGACAAGTCATC	PL-0
CATCAGAGTAGCACGA	PL-robo2
CATCAGAGTCGGCATC	PL-Rel
CATCAGAGTGTGAATA	PL-1
CATCAGAGTTCCGTCT	PL-robo2
CATCAGAGTTCTCATT	PL-3
CATCAGAGTTGGTGGA	PL-2
CATCAGATCACCACCT	PL-Lsp
CATCAGATCACCATAG	PL-robo2
CATCAGATCCTGTACC	PL-1
CATCAGATCGCATGGC	PL-vir1
CATCAGATCTATCCCG	PL-Rel
CATCAGATCTGGTGTA	PL-Rel
CATCCACAGCCATCGC	PL-0
CATCCACAGGACATTA	PL-3
CATCCACAGTACGCGA	PL-1
CATCCACAGTCATCCA	PL-vir1
CATCCACCACCGCTAG	PL-0
CATCCACCAGCGTCCA	PL-2
CATCCACCATCCCACT	PL-2
CATCCACCATTATCTC	PL-robo2
CATCCACGTAAAGGAG	PL-2
CATCCACGTTCGTGAT	PL-0
CATCCACTCAGCACAT	PL-0
CATCCACTCCAGATCA	PL-vir1
CATCCACTCCGTAGTA	PL-2
CATCGAAAGAGATGAG	PL-2
CATCGAAAGAGGGCTT	PL-1
CATCGAAAGATCCGAG	PL-Inos
CATCGAAAGATCCTGT	PL-0
CATCGAACACGTAAGG	PL-2
CATCGAACAGCGTTCG	PL-Rel
CATCGAACAGCTGCTG	PL-1
CATCGAACATAGTAAG	PL-2
CATCGAAGTTAAGTAG	PL-Lsp
CATCGAATCAACGAAA	PL-0
CATCGAATCGCGCCAA	PL-1
CATCGAATCGCGGATC	PL-2
CATCGAATCGGCGCAT	PL-2
CATCGGGAGAAGGGTA	PL-2
CATCGGGAGATCTGAA	PL-0
CATCGGGAGCTGAACG	PL-robo2
CATCGGGAGCTTATCG	PL-2
CATCGGGAGGCAGGTT	PL-1
CATCGGGAGGTTCCTA	PL-Pcd
CATCGGGAGTGGAGTC	PL-2
CATCGGGAGTGTCCAT	PL-0
CATCGGGCAATGTAAG	PL-0
CATCGGGCACGTTGGC	PL-robo2
CATCGGGCATTGAGCT	PL-Rel
CATCGGGCATTGGTAC	PL-2
CATCGGGGTATAAACG	PL-Rel
CATCGGGGTCCTGCTT	PL-prolif
CATCGGGGTTAAAGTG	PL-Rel
CATCGGGTCCTTTCTC	PL-Inos
CATCGGGTCGCACTCT	PL-2
CATCGGGTCGGAAACG	PL-2
CATCGGGTCGGAAATA	PL-2
CATCGGGTCTACTATC	PL-0
CATCGGGTCTCCTATA	PL-Pcd
CATCGGGTCTTGAGGT	PL-0
CATGACAAGACAGAGA	PL-2
CATGACAAGGAATTAC	PL-robo2
CATGACACACCAGGTC	PL-Rel
CATGACACAGCTCCGA	PL-1
CATGACACAGTAACGG	PL-0
CATGACAGTCACCTAA	PL-0
CATGACAGTTCAGGCC	PL-Rel
CATGACAGTTCGCTAA	PL-1
CATGACAGTTGACGTT	PL-3
CATGACATCAGATAAG	PL-Rel
CATGACATCGAGCCCA	PL-2
CATGACATCGGAATCT	PL-3
CATGCCTAGACCGGAT	PL-Rel
CATGCCTAGCAATATG	PL-1
CATGCCTAGTAGTGCG	PL-0
CATGCCTCAACAACCT	PL-Rel
CATGCCTCAAGGCTCC	PL-3
CATGCCTCAGACGTAG	PL-Pcd
CATGCCTGTAGGACAC	PL-0
CATGCCTGTATATGAG	PL-Rel
CATGCCTGTGGCCCTA	PL-0
CATGCCTGTTAGTGGG	PL-1
CATGCCTGTTCGGCAC	PL-0
CATGCCTTCATAGCAC	PL-Pcd
CATGCCTTCCAGATCA	PL-robo2
CATGCCTTCCGCAAGC	PL-0
CATGCCTTCGTCCAGG	PL-1
CATGCCTTCTACCAGA	PL-3
CATGGCGAGACGCAAC	PL-Lsp
CATGGCGAGCATCATC	PL-robo2
CATGGCGAGGCATGTG	PL-Lsp
CATGGCGAGTATCGAA	PL-1
CATGGCGCAAGGACTG	PL-Pcd
CATGGCGCAAGTTCTG	PL-2
CATGGCGCACGGTAGA	PL-Rel
CATGGCGCATCCGCGA	PL-Pcd
CATGGCGCATGCATGT	PL-0
CATGGCGGTTCACCTC	PL-robo2
CATGGCGTCACCATAG	PL-0
CATGGCGTCCCTCAGT	PL-Rel
CATGGCGTCGTCCAGG	PL-1
CATGGCGTCTCTAAGG	PL-3
CATGGCGTCTGCGACG	PL-Rel
CATTATCAGCTGGAAC	PL-vir1
CATTATCAGGAATTAC	PL-0
CATTATCAGGGTTTCT	PL-2
CATTATCCAATAAGCA	PL-Rel
CATTATCCAATGGAGC	PL-0
CATTATCCAGATCGGA	PL-Rel
CATTATCGTAAGTAGT	PL-robo2
CATTATCGTACGCACC	PL-Pcd
CATTATCGTCAGTGGA	PL-Lsp
CATTATCGTGCATCTA	PL-prolif
CATTATCGTTCCGGCA	CC
CATTATCGTTTGGCGC	PL-2
CATTATCTCAAGGTAA	PL-0
CATTCGCAGCAGGCTA	PL-2
CATTCGCAGGATGCGT	PL-1
CATTCGCAGGGCTTGA	PL-1
CATTCGCAGTGTCCAT	PL-Inos
CATTCGCCAATGGAGC	PL-robo2
CATTCGCCACATCCAA	PL-3
CATTCGCCACCAGCAC	PL-0
CATTCGCCACCATGTA	PL-1
CATTCGCCACTAAGTC	PL-0
CATTCGCCAGAGCCAA	PL-0
CATTCGCCAGGCTCAC	PL-Rel
CATTCGCCAGGTGGAT	PL-1
CATTCGCGTCAAAGAT	PL-Pcd
CATTCGCGTCTGATCA	PL-0
CATTCGCGTGCAGTAG	PL-0
CATTCGCTCGGCGCAT	PL-2
CATTCGCTCGTATCAG	PL-robo2
CATTCGCTCTTGAGGT	PL-1
CCAATCCAGAGGTTGC	PL-2
CCAATCCAGATGCCTT	PL-Pcd
CCAATCCAGCCCAACC	PL-0
CCAATCCAGCCGGTAA	PL-2
CCAATCCAGCGTCAAG	PL-Inos
CCAATCCAGGACATTA	PL-Rel
CCAATCCCAATCCGAT	PL-0
CCAATCCCACCACCAG	PL-0
CCAATCCCAGATGGGT	PL-Rel
CCAATCCCAGTCACTA	PL-ImpL2
CCAATCCCATACGCCG	PL-1
CCAATCCGTAATTGGA	PL-0
CCAATCCGTACCGCTG	PL-robo2
CCAATCCGTATTACCG	PL-Inos
CCAATCCGTCGGGTCT	PL-robo2
CCAATCCGTCGTTGTA	PL-2
CCAATCCTCCTTGCCA	PL-1
CCACCTAAGGGATCTG	PL-3
CCACCTACAAGACGTG	PL-1
CCACCTACAAGGGTCA	PL-Rel
CCACCTACAGGAATGC	PL-Rel
CCACCTAGTAAGCACG	PL-1
CCACCTAGTCGCGAAA	PL-robo2
CCACCTAGTCTGCCAG	PL-robo2
CCACCTAGTGGTTTCA	PL-3
CCACCTATCGGCTTGG	PL-1
CCACCTATCGTCACGG	PL-1
CCACCTATCTCACATT	PL-0
CCACCTATCTCGCATC	PL-Inos
CCACCTATCTGCTGTC	PL-Rel
CCACCTATCTTTACAC	PL-0
CCACGGAAGCCAGTTT	PL-Inos
CCACGGAAGCCCAATT	PL-0
CCACGGAAGGTTCCTA	PL-0
CCACGGACAAGTTAAG	PL-0
CCACGGAGTAGAAAGG	PL-1
CCACGGAGTAGCTCCG	PL-Pcd
CCACGGAGTAGGAGTC	PL-0
CCACGGAGTCCAGTGC	PL-0
CCACGGAGTCGCCATG	PL-Pcd
CCACGGAGTCTGCAAT	PL-Rel
CCACGGAGTGTAACGG	PL-Pcd
CCACGGAGTTCAACCA	PL-Lsp
CCACGGAGTTCACGGC	PL-Rel
CCACGGATCAAACGGG	PL-3
CCACGGATCACATAGC	PL-vir1
CCACGGATCACCGGGT	PL-Rel
CCACGGATCAGGCAAG	PL-3
CCACGGATCCGCATAA	PL-1
CCACGGATCCTACAGA	PL-0
CCACGGATCGCTGATA	PL-0
CCACGGATCTGATACG	PL-3
CCACTACAGACAGGCT	PL-3
CCACTACAGAGCCCAA	PL-Rel
CCACTACAGCCGCCTA	PL-0
CCACTACAGCTGTCTA	PL-3
CCACTACAGGGTTTCT	PL-Rel
CCACTACAGTTACCCA	PL-vir1
CCACTACCACCAGGTC	PL-1
CCACTACCATGTCTCC	PL-vir1
CCACTACGTACAAGTA	PL-3
CCACTACGTCAACTGT	PL-0
CCACTACGTGACTACT	PL-1
CCACTACGTGCCTGTG	PL-1
CCAGCGAAGAGTACCG	PL-Rel
CCAGCGAAGATGCCAG	PL-3
CCAGCGAAGTATCGAA	PL-3
CCAGCGAAGTTCGCGC	PL-2
CCAGCGACACATCCGG	PL-0
CCAGCGAGTATCTGCA	PL-vir1
CCAGCGAGTCTCACCT	PL-robo2
CCAGCGAGTTACCAGT	PL-robo2
CCAGCGATCGGGAGTA	PL-robo2
CCAGCGATCTCAACTT	PL-1
CCATGTCAGTCAATAG	PL-2
CCATGTCCAACGATGG	PL-2
CCATGTCCAGCTGTGC	PL-Rel
CCATGTCCAGTAACGG	PL-2
CCATGTCCATATACCG	PL-0
CCATGTCGTCTAGTGT	PL-1
CCATGTCGTTAAGTAG	PL-robo2
CCATGTCGTTCCATGA	PL-Lsp
CCATGTCGTTCTGTTT	PL-2
CCATGTCGTTTAAGCC	PL-Rel
CCATGTCGTTTAGCTG	PL-0
CCATGTCTCTCTAAGG	PL-Lsp
CCATTCGAGAACTGTA	PL-3
CCATTCGAGCTAACTC	PL-1
CCATTCGAGGACACCA	PL-0
CCATTCGAGTACGTAA	PL-1
CCATTCGAGTGAAGAG	PL-3
CCATTCGCAAATACAG	PL-3
CCATTCGCACCTTGTC	PL-1
CCATTCGCACTGCCAG	PL-0
CCATTCGCATCGACGC	PL-Rel
CCATTCGGTCAATACC	PL-Pcd
CCATTCGGTCGAGTTT	PL-Rel
CCATTCGGTCTAGCGC	PL-robo2
CCATTCGGTCTTCAAG	PL-2
CCATTCGGTGCCTGTG	PL-2
CCATTCGGTGTAACGG	PL-robo2
CCATTCGGTGTGCGTC	PL-Rel
CCATTCGTCTCTAAGG	PL-3
CCCAATCAGCGTCAAG	PL-1
CCCAATCCACATCCAA	PL-Rel
CCCAATCCACCACGTG	PL-1
CCCAATCCAGCTGTGC	PL-vir1
CCCAATCCAGGTCCAC	PL-Rel
CCCAATCGTAGCGATG	PL-Inos
CCCAATCGTATATCCG	PL-1
CCCAATCGTCAAAGAT	PL-0
CCCAATCGTCTAGCGC	PL-Rel
CCCAATCGTCTCCCTA	PL-1
CCCAATCGTCTGCAAT	PL-prolif
CCCAATCGTCTGCGGT	PL-2
CCCAATCGTTACCGAT	PL-1
CCCAATCTCACGATGT	PL-1
CCCAATCTCACGGTTA	PL-1
CCCAATCTCCCTTGTG	PL-1
CCCAATCTCCTTGACC	PL-0
CCCAATCTCGCGGATC	PL-Rel
CCCAATCTCGGTCTAA	PL-1
CCCAATCTCTGTCCGT	PL-0
CCCAGTTAGAATTGTG	PL-Lsp
CCCAGTTAGTCTCAAC	PL-2
CCCAGTTAGTGGTCCC	PL-0
CCCAGTTAGTGTCCAT	PL-0
CCCAGTTAGTGTTTGC	PL-Inos
CCCAGTTCAGGTCGTC	PL-1
CCCAGTTGTATGAAAC	PL-1
CCCAGTTGTCAACATC	PL-3
CCCAGTTGTCAGCTAT	PL-2
CCCAGTTGTCATGCAT	PL-Pcd
CCCAGTTGTCTAACGT	PL-1
CCCAGTTGTGTATGGG	PL-robo2
CCCAGTTTCCCTTGCA	PL-2
CCCAGTTTCGGAATCT	PL-Rel
CCCAGTTTCTATGTGG	PL-0
CCCAGTTTCTCGGACG	PL-vir1
CCCAGTTTCTCGTATT	PL-0
CCCAGTTTCTGCCCTA	PL-Pcd
CCCAGTTTCTTGCAAG	PL-3
CCCATACAGACCCACC	PL-1
CCCATACAGATGTCGG	PL-2
CCCATACAGCACCGCT	PL-Pcd
CCCATACCACACTGCG	PL-0
CCCATACCACATGTGT	PL-0
CCCATACCACGAGAGT	PL-Rel
CCCATACCATCCGTGG	PL-2
CCCATACGTAATCGTC	PL-2
CCCATACGTAGGGACT	PL-Rel
CCCATACGTATATCCG	PL-2
CCCATACGTGTGAATA	PL-0
CCCATACGTTAGATGA	PL-3
CCCATACGTTTAAGCC	PL-3
CCCATACTCAAAGTAG	PL-0
CCCATACTCACAAACC	PL-2
CCCATACTCATCGCTC	PL-2
CCCATACTCCGCAAGC	PL-2
CCCATACTCCTTTCGG	PL-1
CCCATACTCGCCAAAT	PL-0
CCCTCCTCAATAAGCA	PL-Inos
CCCTCCTCAATTGCTG	PL-3
CCCTCCTCAGCTGCAC	PL-1
CCCTCCTCATGGTCTA	PL-1
CCCTCCTGTAGCTGCC	PL-1
CCCTCCTGTTCGCGAC	PL-1
CCCTCCTTCAACCATG	PL-0
CCCTCCTTCATCTGCC	PL-2
CCCTCCTTCTTGCAAG	PL-robo2
CCCTCCTTCTTGCATT	CC
CCGGGATAGAGTACCG	PL-2
CCGGGATAGCAATATG	PL-1
CCGGGATAGCGCTCCA	PL-0
CCGGGATAGGATGCGT	PL-1
CCGGGATAGTCAAGGC	PL-robo2
CCGGGATCACAAGACG	PL-Rel
CCGGGATCAGGGCATA	PL-Inos
CCGGGATCATAGAAAC	PL-Rel
CCGGGATGTATCAGTC	PL-3
CCGGGATGTCGAAAGC	PL-1
CCGGGATGTCGTCTTC	PL-Rel
CCGGGATGTTGTGGCC	PL-vir1
CCGGTAGAGCGTGTCC	PL-1
CCGGTAGAGGACAGAA	PL-2
CCGGTAGAGGACAGCT	PL-Inos
CCGGTAGAGGATTCGG	PL-0
CCGGTAGAGTCTCAAC	PL-1
CCGGTAGAGTGGGATC	PL-0
CCGGTAGCACTTAACG	PL-Pcd
CCGGTAGCATGCAACT	PL-1
CCGGTAGGTCTGCGGT	PL-Rel
CCGGTAGGTGAGGGTT	PL-1
CCGGTAGGTGTAAGTA	PL-1
CCGGTAGTCATCACCC	PL-2
CCGGTAGTCCCTCTTT	PL-0
CCGGTAGTCTGTTTGT	PL-robo2
CCGGTAGTCTTATCTG	PL-1
CCGTACTAGTGAAGAG	PL-3
CCGTACTAGTGTGAAT	PL-vir1
CCGTACTCACGTGAGA	PL-robo2
CCGTACTCAGATGGCA	PL-2
CCGTACTCATACTACG	PL-Lsp
CCGTACTGTAAGAGGA	PL-1
CCGTACTGTACACCGC	PL-1
CCGTACTGTCTTTCAT	PL-Rel
CCGTACTGTGATGATA	PL-1
CCGTACTGTGTGGCTC	PL-Rel
CCGTACTGTTATGTGC	PL-1
CCGTACTTCAACACCA	PL-2
CCGTACTTCAAGGCTT	PL-1
CCGTACTTCACTTACT	PL-0
CCGTACTTCCGCGTTT	PL-2
CCGTACTTCGGACAAG	PL-1
CCGTACTTCGGTGTCG	PL-0
CCGTACTTCTAACTCT	PL-2
CCGTACTTCTGTCAAG	PL-1
CCGTGGAAGAATCTCC	PL-robo2
CCGTGGAAGTCCGGTC	PL-vir1
CCGTGGAGTAATAGCA	PL-2
CCGTGGAGTAGGACAC	PL-1
CCGTGGAGTGACGGTA	PL-Rel
CCGTGGATCCAACCAA	PL-Rel
CCGTGGATCCCTTGTG	PL-Rel
CCGTGGATCGGGAGTA	PL-robo2
CCGTTCAAGAAACCAT	PL-1
CCGTTCAAGAGACTAT	PL-vir1
CCGTTCAAGTCTTGCA	PL-robo2
CCGTTCACAAATTGCC	PL-Rel
CCGTTCACACAACGTT	PL-vir1
CCGTTCACACTGCCAG	PL-vir1
CCGTTCACACTTAACG	PL-3
CCGTTCACACTTAAGC	PL-2
CCGTTCACAGCTATTG	PL-Rel
CCGTTCACATCCCACT	PL-0
CCGTTCACATGTCCTC	PL-Inos
CCGTTCAGTAATAGCA	PL-3
CCGTTCAGTACACCGC	PL-Inos
CCGTTCAGTATCTGCA	PL-Pcd
CCGTTCATCCATGCTC	PL-2
CCGTTCATCTCTAGGA	PL-robo2
CCGTTCATCTGAAAGA	PL-2
CCGTTCATCTTTCCTC	PL-2
CCTAAAGCAAAGTGCG	PL-Pcd
CCTAAAGCACGAAACG	PL-robo2
CCTAAAGCAGTAAGAT	PL-Pcd
CCTAAAGCATTGGCGC	PL-1
CCTAAAGGTACCCAAT	PL-2
CCTAAAGGTATCAGTC	PL-2
CCTAAAGGTCATACTG	PL-3
CCTAAAGGTCGCTTCT	PL-0
CCTAAAGGTCTCAACA	PL-3
CCTAAAGGTCTTGCGG	PL-0
CCTAAAGGTGAAAGAG	PL-2
CCTAAAGGTGCAGGTA	PL-2
CCTAAAGGTGTGAATA	PL-0
CCTAAAGTCACTTACT	PL-Lsp
CCTAAAGTCCTCCTAG	PL-Pcd
CCTAAAGTCTGTGCAA	PL-Lsp
CCTACACAGTATTGGA	PL-Lsp
CCTACACAGTCGATAA	PL-3
CCTACACCACGACGAA	PL-1
CCTACACGTGACGCCT	PL-1
CCTACACGTGGTCTCG	PL-3
CCTACACGTTCGGCAC	PL-2
CCTACACTCACTATTC	PL-2
CCTACACTCATCATTC	PL-2
CCTACACTCCCATTAT	PL-Rel
CCTACACTCTTGTATC	PL-3
CCTACCAAGACTGGGT	PL-1
CCTACCAAGCACCGTC	PL-1
CCTACCAAGGGTGTGT	PL-Pcd
CCTACCAAGTCGTACT	PL-2
CCTACCACAAACTGTC	PL-0
CCTACCACAATCACAC	PL-1
CCTACCACAATGGACG	PL-1
CCTACCACATTCACTT	PL-vir1
CCTACCAGTAGCGCAA	PL-2
CCTACCAGTCACAAGG	PL-2
CCTACCAGTCCAGTAT	PL-2
CCTACCAGTCCATCCT	PL-0
CCTACCAGTGCGATAG	PL-2
CCTACCATCACAACGT	PL-Lsp
CCTAGCTAGATGCGAC	PL-1
CCTAGCTAGGATATAC	PL-Rel
CCTAGCTCACCCATTC	PL-Pcd
CCTAGCTCAGGTCCAC	PL-1
CCTAGCTCAGTTAACC	PL-Inos
CCTAGCTGTATATGAG	PL-2
CCTAGCTGTTACCGAT	PL-Rel
CCTAGCTGTTCTGAAC	PL-3
CCTAGCTGTTGTCGCG	PL-1
CCTAGCTTCAACGGGA	PL-2
CCTAGCTTCACTTACT	PL-3
CCTAGCTTCGGCTACG	PL-2
CCTAGCTTCGTCACGG	PL-2
CCTATTAAGCGGCTTC	PL-0
CCTATTAAGCGTTGCC	PL-robo2
CCTATTACAGACAGGT	PL-0
CCTATTACAGCAGTTT	PL-2
CCTATTACAGCGTCCA	PL-2
CCTATTACATAACCTG	PL-prolif
CCTATTACATGCTGGC	PL-0
CCTATTAGTATAAACG	PL-1
CCTATTAGTATTAGCC	PL-2
CCTATTAGTCCATCCT	PL-2
CCTATTAGTCCGACGT	PL-2
CCTATTAGTCGAAAGC	PL-1
CCTATTAGTCGTGGCT	PL-1
CCTATTAGTTGAGTTC	PL-vir1
CCTATTAGTTTCCACC	PL-1
CCTATTATCATCGATG	PL-0
CCTATTATCCAAAGTC	PL-robo2
CCTATTATCGTCTGAA	PL-3
CCTATTATCGTTACGA	PL-2
CCTATTATCTTGAGAC	PL-0
CCTCAGTAGGGTGTTG	PL-Lsp
CCTCAGTAGTCATCCA	PL-0
CCTCAGTAGTCGTTTG	PL-Lsp
CCTCAGTAGTTCCACA	PL-vir1
CCTCAGTCAAGCCGCT	PL-2
CCTCAGTCACACATGT	PL-robo2
CCTCAGTCAGATGGGT	PL-robo2
CCTCAGTCATATGGTC	PL-1
CCTCAGTGTTAAGGGC	PL-robo2
CCTCAGTTCACAATGC	PL-0
CCTCAGTTCACTATTC	PL-1
CCTCAGTTCCGCTGTT	PL-2
CCTCAGTTCCGTAGTA	PL-0
CCTCAGTTCGGCGCTA	PL-1
CCTCTGAAGGTAGCCA	PL-1
CCTCTGAAGTCTCCTC	PL-3
CCTCTGACACAGGTTT	PL-robo2
CCTCTGACAGTCAGAG	PL-3
CCTCTGACATGTAAGA	PL-3
CCTCTGAGTAGAGCTG	PL-3
CCTCTGAGTATATGGA	PL-vir1
CCTCTGAGTCATCGGC	PL-0
CCTCTGAGTTATGTGC	PL-Rel
CCTCTGATCAATCACG	PL-Rel
CCTCTGATCACCGGGT	PL-Rel
CCTCTGATCCGTAGTA	PL-1
CCTCTGATCTAGCACA	PL-1
CCTCTGATCTTCGAGA	PL-2
CCTTACGAGATCACGG	PL-2
CCTTACGAGCAATATG	PL-3
CCTTACGAGCCTTGAT	PL-1
CCTTACGAGGAGTTTA	PL-2
CCTTACGAGGCACATG	PL-Rel
CCTTACGCAATAGAGT	PL-1
CCTTACGCATAAAGGT	PL-1
CCTTACGCATCATCCC	PL-Rel
CCTTACGCATCCGCGA	PL-2
CCTTACGCATTTGCTT	PL-0
CCTTACGGTACTTAGC	PL-Lsp
CCTTACGGTGGCAAAC	PL-3
CCTTACGGTTAAGAAC	PL-1
CCTTACGGTTTGTTTC	PL-1
CCTTACGTCCCAAGTA	PL-robo2
CCTTACGTCTGGAGCC	PL-0
CCTTACGTCTGTACGA	PL-2
CCTTCCCAGAGGTTGC	PL-0
CCTTCCCAGAGTGACC	PL-Rel
CCTTCCCAGGACTGGT	PL-0
CCTTCCCAGTACGACG	PL-1
CCTTCCCAGTCAAGCG	PL-0
CCTTCCCAGTCAATAG	PL-2
CCTTCCCCACAGACTT	PL-3
CCTTCCCCAGTAAGAT	PL-Rel
CCTTCCCGTCCTCCAT	PL-0
CCTTCCCGTCTAGAGG	PL-Rel
CCTTCCCGTGACTCAT	PL-1
CCTTCCCGTTCACGGC	PL-Rel
CCTTCCCTCAAACGGG	PL-0
CCTTCCCTCCCTTGCA	PL-vir1
CCTTCCCTCTGATACG	PL-Rel
CCTTCGAAGACTACAA	PL-Rel
CCTTCGACAATCACAC	PL-1
CCTTCGACACAGACAG	PL-3
CCTTCGACAGACGCAA	PL-1
CCTTCGACATTACCTT	PL-Inos
CCTTCGAGTAATCACC	PL-robo2
CCTTCGAGTCTCCATC	PL-2
CCTTCGATCCACGACG	PL-3
CCTTCGATCTGTGCAA	PL-Lsp
CCTTTCTAGCGCCTTG	PL-1
CCTTTCTCAACGATCT	PL-0
CCTTTCTCATACTACG	PL-Inos
CCTTTCTCATGAAGTA	PL-0
CCTTTCTCATGACGGA	PL-3
CCTTTCTGTAAGTGGC	PL-Rel
CCTTTCTGTACCGCTG	PL-2
CCTTTCTGTCACTTCC	PL-Rel
CCTTTCTGTCGTCTTC	PL-Inos
CCTTTCTGTGCATCTA	PL-vir1
CCTTTCTGTTACAGAA	PL-2
CCTTTCTGTTCATGGT	PL-3
CCTTTCTTCATGTCTT	PL-0
CGAACATAGCGACGTA	PL-vir1
CGAACATAGCGATAGC	PL-2
CGAACATAGCTAGTCT	PL-1
CGAACATAGCTCTCGG	PL-1
CGAACATAGCTGCAAG	PL-vir1
CGAACATAGTCTCAAC	PL-1
CGAACATAGTGCCATT	PL-robo2
CGAACATCAATGGAAT	PL-0
CGAACATCAATTCCTT	PL-3
CGAACATCAGACTCGC	PL-vir1
CGAACATCATGCCACG	PL-0
CGAACATCATTGAGCT	PL-0
CGAACATGTGCGATAG	PL-Rel
CGAACATGTGGTCTCG	PL-vir1
CGAACATGTGTGAATA	PL-2
CGAACATGTTCAGACT	PL-0
CGAACATGTTCCCGAG	PL-3
CGAACATTCCAACCAA	PL-2
CGAACATTCCGCAAGC	PL-Rel
CGAACATTCCGCGCAA	PL-2
CGAACATTCGCCATAA	PL-0
CGAATGTAGATCGATA	PL-1
CGAATGTAGCCGCCTA	PL-3
CGAATGTAGGCTACGA	PL-3
CGAATGTAGTGAACGC	PL-Rel
CGAATGTAGTGAAGAG	PL-2
CGAATGTAGTGGAGAA	PL-2
CGAATGTCACCCATGG	PL-1
CGAATGTCACTTAACG	PL-0
CGAATGTCAGGACCCT	PL-vir1
CGAATGTCAGGCTGAA	PL-robo2
CGAATGTCAGTAGAGC	PL-ImpL2
CGAATGTCATCCGTGG	PL-Pcd
CGAATGTGTATTCTCT	PL-2
CGAATGTTCAAACCGT	PL-Rel
CGAATGTTCAAGAAGT	PL-1
CGAATGTTCCGAGCCA	PL-1
CGAATGTTCCGTTGTC	PL-3
CGAATGTTCGCCCTTA	PL-Rel
CGAATGTTCGGATGTT	PL-2
CGACCTTAGCAGATCG	PL-robo2
CGACCTTAGTGTGAAT	PL-robo2
CGACCTTAGTTGTAGA	PL-2
CGACCTTCACGGCCAT	PL-Inos
CGACCTTCAGATGAGC	PL-0
CGACCTTCAGCATGAG	PL-Inos
CGACCTTCATCCGTGG	PL-Rel
CGACCTTCATTAGGCT	PL-0
CGACCTTGTAGCACGA	PL-Rel
CGACCTTTCATAACCG	PL-robo2
CGACCTTTCCAAAGTC	PL-2
CGACCTTTCCACGACG	PL-2
CGACCTTTCCGAACGC	PL-vir1
CGACCTTTCCTCGCAT	PL-vir1
CGACCTTTCCTGTAGA	PL-0
CGACCTTTCGGCTTGG	PL-3
CGACCTTTCTACGAGT	PL-Rel
CGACCTTTCTGCCAGG	PL-0
CGACCTTTCTGCGACG	PL-2
CGACCTTTCTGCTTGC	PL-0
CGACTTCAGCAATATG	PL-vir1
CGACTTCAGTACATGA	PL-3
CGACTTCCAAAGCGGT	PL-2
CGACTTCCACAAGACG	LM-1
CGACTTCGTCGCCATG	PL-AMP
CGACTTCGTGTGACGA	PL-robo2
CGACTTCTCAGGATCT	PL-2
CGACTTCTCAGTCAGT	PL-vir1
CGACTTCTCCATGAAC	PL-robo2
CGACTTCTCGTGACAT	PL-robo2
CGAGAAGAGCCGATTT	PL-Rel
CGAGAAGAGCGCTCCA	PL-Rel
CGAGAAGAGCTAGCCC	PL-Rel
CGAGAAGAGCTAGGCA	PL-Rel
CGAGAAGAGTCAAGGC	PL-Rel
CGAGAAGAGTGACTCT	PL-Lsp
CGAGAAGCAACAACCT	PL-1
CGAGAAGCACATTCGA	PL-2
CGAGAAGCAGGCGATA	PL-2
CGAGAAGCAGTAACGG	PL-0
CGAGAAGCATCCGGGT	PL-2
CGAGAAGCATCGGGTC	PL-2
CGAGAAGCATGGTCAT	PL-3
CGAGAAGGTATCGCAT	PL-2
CGAGAAGGTGAGGCTA	PL-1
CGAGAAGGTGAGTGAC	PL-0
CGAGAAGGTGATGTCT	PL-2
CGAGAAGGTGCACTTA	PL-0
CGAGAAGGTTGCTCCT	PL-1
CGAGAAGGTTGGTTTG	CC
CGAGAAGGTTTCGCTC	PL-1
CGAGAAGTCAACCAAC	PL-Rel
CGAGCACAGACAAGCC	PL-vir1
CGAGCACAGCAACGGT	PL-Inos
CGAGCACAGCGCTCCA	PL-Pcd
CGAGCACCACCACCAG	PL-0
CGAGCACCACGAAATA	PL-1
CGAGCACCACGAGAGT	PL-2
CGAGCACCACGTCTCT	PL-robo2
CGAGCACCAGTCAGCC	PL-Pcd
CGAGCACCATGCAACT	PL-3
CGAGCACGTAATAGCA	PL-Pcd
CGAGCACGTCCGAACC	PL-1
CGAGCACGTCCGTTAA	PL-Inos
CGAGCACGTTCTCATT	PL-2
CGAGCACTCAACCAAC	PL-1
CGAGCACTCAGTTAGC	PL-0
CGAGCACTCATAAAGG	PL-Rel
CGAGCACTCCCATTAT	PL-Rel
CGAGCACTCTAACCGA	PL-1
CGAGCACTCTGCCCTA	PL-Pcd
CGAGCCAAGTCGATAA	PL-3
CGAGCCACAAGCCTAT	PL-0
CGAGCCACAAGCGAGT	PL-3
CGAGCCACACGGTAGA	PL-2
CGAGCCAGTCCTAGCG	PL-3
CGAGCCAGTCTCCACT	PL-Lsp
CGAGCCAGTCTCCCTA	PL-vir1
CGAGCCAGTGACAAAT	PL-0
CGAGCCATCGTTACAG	PL-0
CGATCGGAGATCCCAT	PL-0
CGATCGGAGCTGCAAG	PL-1
CGATCGGCAAAGTGCG	PL-0
CGATCGGCAAGCGAGT	PL-robo2
CGATCGGCAATAGAGT	PL-vir1
CGATCGGCACCACCAG	PL-Pcd
CGATCGGCACGACTCG	PL-0
CGATCGGCAGCTGCAC	PL-0
CGATCGGCAGGTCTCG	PL-3
CGATCGGCAGTCAGAG	PL-2
CGATCGGCATCCCACT	PL-0
CGATCGGCATTGGCGC	PL-0
CGATCGGGTCGGCTCA	PL-3
CGATCGGGTCTTGTCC	PL-Rel
CGATCGGGTGAAATCA	PL-Rel
CGATCGGTCAAGCCTA	PL-2
CGATCGGTCCTGTACC	PL-Pcd
CGATCGGTCCTTGGTC	PL-2
CGATCGGTCGCGTTTC	PL-0
CGATCGGTCTGCGACG	PL-1
CGATCGGTCTGTTTGT	PL-robo2
CGATGGCAGCCACGTC	PL-0
CGATGGCAGCGCTCCA	PL-vir1
CGATGGCAGGCGACAT	PL-0
CGATGGCAGGTGTTAA	PL-Pcd
CGATGGCCACATTTCT	PL-0
CGATGGCCACGACTCG	PL-Inos
CGATGGCCAGACGTAG	PL-2
CGATGGCCAGCTGCTG	PL-0
CGATGGCCAGGTCCAC	PL-0
CGATGGCCATCCAACA	PL-1
CGATGGCCATCGGGTC	PL-1
CGATGGCGTCGAGTTT	PL-Rel
CGATGGCGTGCGGTAA	PL-2
CGATGGCGTTACGACT	PL-0
CGATGGCTCACGACTA	PL-1
CGATGGCTCGGATGGA	PL-Pcd
CGATGTAAGCGTCTAT	PL-2
CGATGTAAGGGATACC	PL-Pcd
CGATGTAAGTTGCAGG	PL-0
CGATGTACACCGAATT	PL-0
CGATGTACAGACGCAA	PL-robo2
CGATGTACATACTACG	PL-Rel
CGATGTAGTACCGTAT	PL-0
CGATGTAGTACGAAAT	PL-0
CGATGTAGTCCAAGTT	PL-0
CGATGTAGTCTCATCC	PL-2
CGATGTATCCAAATGC	PL-0
CGATGTATCGCCATAA	PL-Pcd
CGATGTATCGTAGGTT	PL-3
CGATTGAAGATGCCAG	PL-3
CGATTGAAGGGATGGG	PL-2
CGATTGAAGTCCGTAT	PL-AMP
CGATTGACAAACCCAT	PL-robo2
CGATTGACAACACGCC	CC
CGATTGACAAGTCTGT	PL-2
CGATTGACAATCCGAT	PL-0
CGATTGACACATAACC	PL-vir1
CGATTGACAGGCTCAC	PL-2
CGATTGACAGTCTTCC	PL-2
CGATTGACAGTTCATG	PL-Inos
CGATTGAGTAACGACG	PL-3
CGATTGAGTAAGGATT	PL-Pcd
CGATTGAGTATAGGGC	PL-0
CGATTGAGTTGAGTTC	PL-1
CGATTGATCCGCTGTT	PL-robo2
CGATTGATCGCTTGTC	PL-2
CGCCAAGAGATCGATA	PL-0
CGCCAAGAGATTACCC	PL-robo2
CGCCAAGAGGAGCGAG	PL-Rel
CGCCAAGAGTCTCCTC	PL-Rel
CGCCAAGCACCCATGG	PL-Pcd
CGCCAAGCAGCTGTGC	PL-Pcd
CGCCAAGGTCACTGGC	PL-2
CGCCAAGGTCCCTACT	PL-2
CGCCAAGGTCTCTCTG	PL-2
CGCCAAGGTGTCGCTG	PL-1
CGCCAAGTCACCACCT	PL-Inos
CGCCAAGTCAGGATCT	PL-2
CGCCAAGTCATGTAGC	PL-2
CGCCAAGTCCACTCCA	PL-2
CGCCAAGTCCAGTATG	PL-vir1
CGCCAAGTCCCTCAGT	PL-3
CGCCAAGTCCTACAGA	PL-0
CGCCAAGTCGTTACAG	PL-2
CGCGGTAAGCCATCGC	PL-0
CGCGGTAAGTTCGCGC	PL-0
CGCGGTACAAGCGATG	PL-robo2
CGCGGTACACGAGGTA	PL-vir1
CGCGGTAGTAAGTAGT	PL-Rel
CGCGGTAGTACAGTTC	PL-2
CGCGGTAGTATCAGTC	PL-Inos
CGCGGTAGTCACCTAA	PL-1
CGCGGTAGTCATGCAT	PL-1
CGCGGTAGTGTTCTTT	PL-3
CGCGGTAGTTCCACAA	PL-vir1
CGCGGTATCAACGGGA	PL-Pcd
CGCGGTATCGGACAAG	PL-1
CGCGGTATCGTAGGTT	PL-0
CGCGTTTCAAGCCTAT	PL-2
CGCGTTTCACAGGCCT	PL-2
CGCGTTTCACTACAGT	PL-0
CGCGTTTCAGGATTGG	PL-robo2
CGCGTTTCATCAGTAC	PL-Rel
CGCGTTTGTCAAAGCG	PL-2
CGCGTTTGTCTAGAGG	PL-robo2
CGCGTTTGTCTGGAGA	PL-Pcd
CGCGTTTGTGACTCAT	PL-3
CGCGTTTGTTATCACG	PL-1
CGCGTTTGTTATCGGT	PL-2
CGCGTTTGTTCGTCTC	PL-2
CGCGTTTGTTTGACTG	PL-2
CGCGTTTTCCACGCAG	PL-1
CGCGTTTTCTACCAGA	PL-3
CGCGTTTTCTGCAAGT	PL-1
CGCGTTTTCTGCTGTC	PL-3
CGCTATCAGCATGGCA	PL-0
CGCTATCAGCGAGAAA	PL-0
CGCTATCCAACACCCG	PL-0
CGCTATCCAACGATCT	PL-0
CGCTATCCAATGGAGC	PL-2
CGCTATCCACGGCCAT	PL-robo2
CGCTATCCAGCTGGCT	PL-1
CGCTATCCATCAGTCA	PL-robo2
CGCTATCCATCGGTTA	PL-0
CGCTATCGTAAAGGAG	PL-0
CGCTATCGTCATACTG	PL-0
CGCTATCGTCGGGTCT	PL-Rel
CGCTATCTCAAACCGT	PL-Pcd
CGCTATCTCAGGTTCA	PL-3
CGCTATCTCCGTCAAA	PL-2
CGCTATCTCTGTCTCG	PL-Rel
CGCTGGAAGAAGGTTT	PL-Pcd
CGCTGGAAGTACGCGA	PL-0
CGCTGGACACATTAGC	PL-prolif
CGCTGGACATAAGACA	PL-Rel
CGCTGGACATAGACTC	PL-1
CGCTGGACATATACGC	PL-3
CGCTGGACATGTCGAT	PL-3
CGCTGGAGTAAGAGGA	PL-0
CGCTGGAGTCCAGTTA	PL-robo2
CGCTGGAGTGGCAAAC	PL-vir1
CGCTGGAGTGTGAAAT	PL-0
CGCTGGAGTTGGTAAA	PL-1
CGCTGGATCCCAAGTA	PL-Rel
CGCTGGATCCTATGTT	PL-2
CGCTGGATCGTGACAT	PL-robo2
CGCTGGATCTCTTGAT	PL-0
CGCTGGATCTGGTGTA	PL-0
CGCTGGATCTTTACAC	PL-0
CGCTGGATCTTTAGTC	PL-Lsp
CGCTTCAAGATGTGTA	PL-1
CGCTTCAAGCAATATG	PL-2
CGCTTCAAGTGAACGC	PL-Lsp
CGCTTCACACGGTGTC	PL-3
CGCTTCACAGACACTT	CC
CGCTTCACAGCTGGCT	PL-2
CGCTTCACAGTACACT	PL-0
CGCTTCAGTAAGAGAG	PL-1
CGCTTCAGTACCGGCT	PL-Rel
CGCTTCAGTCAGAAGC	PL-3
CGCTTCATCAACACAC	CC
CGCTTCATCGTGGGAA	PL-3
CGCTTCATCTACTATC	PL-0
CGCTTCATCTGCCAGG	PL-robo2
CGGACACAGACGCTTT	PL-0
CGGACACAGGACACCA	PL-3
CGGACACAGGAGTAGA	PL-0
CGGACACAGGATGGTC	PL-0
CGGACACAGTAACCCT	PL-1
CGGACACAGTCCAGGA	PL-0
CGGACACAGTGAAGAG	PL-Rel
CGGACACAGTTTCCTT	PL-Inos
CGGACACCAAGCCATT	PL-robo2
CGGACACCACTAGTAC	PL-1
CGGACACCATAAGACA	PL-2
CGGACACCATTGGTAC	PL-Pcd
CGGACACGTAGGGTAC	PL-Pcd
CGGACACGTTTGCATG	PL-3
CGGACACTCACATAGC	PL-2
CGGACACTCCTAAGTG	PL-3
CGGACACTCCTTGACC	PL-1
CGGACGTAGACTGTAA	PL-3
CGGACGTAGAGTCTGG	PL-1
CGGACGTAGCCAGGAT	PL-Pcd
CGGACGTAGTATGACA	PL-1
CGGACGTCAATACGCT	PL-2
CGGACGTCACGGTAAG	PL-1
CGGACGTCACTCGACG	PL-1
CGGACGTCACTTACGA	PL-3
CGGACGTGTAAGGATT	PL-Inos
CGGACGTGTACCGGCT	PL-Rel
CGGACGTGTACTCAAC	PL-robo2
CGGACGTGTAGTAGTA	PL-2
CGGACGTGTCACACGC	PL-1
CGGACGTTCCACGTGG	PL-Rel
CGGACGTTCTTGGGTA	PL-0
CGGACGTTCTTGTCAT	PL-1
CGGACTGAGATTACCC	PL-robo2
CGGACTGAGCAGGCTA	PL-robo2
CGGACTGAGCCTTGAT	PL-1
CGGACTGAGCTTTGGT	PL-Rel
CGGACTGAGGGCTTGA	PL-2
CGGACTGAGTATTGGA	PL-2
CGGACTGAGTGACTCT	PL-AMP
CGGACTGCAAGACACG	PL-0
CGGACTGGTATTAGCC	PL-vir1
CGGACTGGTCTCTCGT	PL-1
CGGACTGGTTCCACGG	PL-vir1
CGGACTGTCCCACTTG	PL-Rel
CGGACTGTCGAACTGT	PL-1
CGGACTGTCGTTGCCT	PL-Pcd
CGGACTGTCTGCCAGG	PL-0
CGGAGCTAGGCCCTCA	PL-Rel
CGGAGCTAGGGATCTG	PL-3
CGGAGCTAGGGTTCCC	PL-3
CGGAGCTAGTTAAGTG	PL-2
CGGAGCTCAAGTCTAC	PL-0
CGGAGCTCAGCCAATT	PL-0
CGGAGCTCAGGGTATG	PL-Pcd
CGGAGCTGTAGCTAAA	PL-robo2
CGGAGCTGTCTCCACT	PL-1
CGGAGCTGTGCGAAAC	PL-3
CGGAGCTGTTAAGATG	PL-2
CGGAGCTGTTATCCGA	PL-Rel
CGGAGCTGTTCCCTTG	PL-3
CGGAGCTTCAGTCCCT	PL-0
CGGAGCTTCCGAACGC	PL-Rel
CGGAGCTTCCGCATAA	PL-Rel
CGGAGCTTCTAAGCCA	PL-3
CGGAGCTTCTGTGCAA	PL-0
CGGAGTCAGACCGGAT	PL-Pcd
CGGAGTCAGCAGCCTC	PL-prolif
CGGAGTCAGCGATGAC	PL-3
CGGAGTCAGGTGATTA	PL-2
CGGAGTCCAGCTGGCT	PL-Rel
CGGAGTCCATCTACGA	PL-3
CGGAGTCGTACGAAAT	PL-2
CGGAGTCGTCAAAGCG	PL-Rel
CGGAGTCGTCTCAACA	PL-0
CGGAGTCGTGATAAGT	PL-0
CGGAGTCGTGCACGAA	PL-1
CGGAGTCTCAAACCAC	PL-1
CGGAGTCTCCCTTGTG	PL-Pcd
CGGAGTCTCGAGCCCA	PL-1
CGGAGTCTCGCTAGCG	PL-0
CGGAGTCTCTTGCATT	PL-0
CGGCTAGAGAAGGACA	PL-2
CGGCTAGAGCCAGTTT	PL-0
CGGCTAGAGTGCCAGA	PL-vir1
CGGCTAGAGTTAGGTA	PL-1
CGGCTAGCAATAGCAA	PL-1
CGGCTAGCATCGTCGG	PL-3
CGGCTAGCATGGAATA	PL-3
CGGCTAGGTACGCACC	PL-0
CGGCTAGGTTTACTCT	PL-1
CGGCTAGTCAGTTAGC	PL-robo2
CGGCTAGTCCTTGCCA	PL-3
CGGCTAGTCGGAGGTA	PL-vir1
CGGCTAGTCTTCGAGA	PL-2
CGGGTCAAGAGACTTA	PL-vir1
CGGGTCAAGATATGGT	PL-Inos
CGGGTCAAGCGAAGGG	PL-Pcd
CGGGTCAAGGCAAAGA	PL-Rel
CGGGTCAAGGGCATGT	PL-robo2
CGGGTCAAGTTAGCGG	PL-Rel
CGGGTCACAAGCGCTC	PL-3
CGGGTCACAGTGGGAT	PL-Pcd
CGGGTCACATGGTTGT	PL-1
CGGGTCACATTGGGCC	PL-0
CGGGTCAGTACTCTCC	PL-0
CGGGTCAGTGCGGTAA	PL-2
CGGGTCATCAACTCTT	PL-0
CGGGTCATCGGAGGTA	PL-3
CGGGTCATCTCCTATA	PL-Rel
CGGGTCATCTCTTATG	PL-1
CGGGTCATCTGCGACG	PL-2
CGGTTAAAGGAGTAGA	PL-vir1
CGGTTAAAGGCGACAT	PL-2
CGGTTAAAGTCACGCC	PL-Inos
CGGTTAAAGTGCCAGA	PL-2
CGGTTAACAAACGTGG	PL-3
CGGTTAACACCAGTTA	PL-Rel
CGGTTAACACTTAAGC	PL-Inos
CGGTTAACAGAGCCAA	PL-2
CGGTTAACAGTAAGCG	PL-2
CGGTTAACATCACCCT	PL-0
CGGTTAAGTAGTGAAT	PL-vir1
CGGTTAAGTTGATTCG	PL-Rel
CGGTTAATCAATAAGG	PL-Rel
CGGTTAATCCAGTAGT	PL-Lsp
CGGTTAATCCTATTCA	PL-robo2
CGGTTAATCCTCATTA	PL-2
CGGTTAATCTCCGGTT	PL-vir1
CGGTTAATCTGAGTGT	PL-AMP
CGTAGCGAGGGAGTAA	PL-0
CGTAGCGAGTGTTAGA	PL-2
CGTAGCGCAAGCTGTT	PL-Rel
CGTAGCGCACTGCCAG	PL-Rel
CGTAGCGCAGACGCCT	PL-3
CGTAGCGCAGGTGGAT	PL-3
CGTAGCGGTAAACCTC	PL-3
CGTAGCGGTAGATTAG	PL-3
CGTAGCGGTATCAGTC	PL-Pcd
CGTAGCGGTCCGAATT	PL-0
CGTAGCGGTTGTGGAG	PL-Pcd
CGTAGCGTCAAACCAC	PL-0
CGTAGCGTCAACACTG	PL-0
CGTAGCGTCACAATGC	PL-Rel
CGTAGCGTCCTACAGA	PL-3
CGTAGCGTCGACAGCC	PL-1
CGTAGGCAGCAATATG	PL-2
CGTAGGCAGGTAAACT	PL-Rel
CGTAGGCAGTAACCCT	PL-2
CGTAGGCCAAAGCAAT	PL-2
CGTAGGCCACATGGGA	PL-1
CGTAGGCCACTTGGAT	PL-Rel
CGTAGGCGTTAGATGA	PL-Pcd
CGTAGGCGTTCCGGCA	PL-vir1
CGTAGGCTCAAACAAG	PL-0
CGTAGGCTCACGGTTA	PL-0
CGTAGGCTCCAGTAGT	PL-prolif
CGTAGGCTCGGTGTCG	PL-2
CGTAGGCTCTTAGAGC	PL-2
CGTAGGCTCTTGTTTG	PL-0
CGTCACTAGACCACGA	PL-2
CGTCACTAGAGTAAGG	PL-3
CGTCACTAGCTCCCAG	PL-0
CGTCACTAGTGTCTCA	PL-0
CGTCACTCAAGAAAGG	PL-2
CGTCACTCAATGGAGC	PL-3
CGTCACTCACCAGTTA	PL-Rel
CGTCACTCACCGAAAG	PL-Rel
CGTCACTCACGTTGGC	PL-3
CGTCACTCAGGTTTCA	PL-AMP
CGTCACTGTAAATACG	PL-robo2
CGTCACTGTCAGAAGC	PL-robo2
CGTCACTTCAGCCTAA	CC
CGTCAGGAGAGACGAA	PL-0
CGTCAGGAGCTTATCG	PL-0
CGTCAGGAGGATGGAA	PL-1
CGTCAGGAGGTAGCTG	PL-Pcd
CGTCAGGAGTGCGATG	PL-Rel
CGTCAGGCAAAGCAAT	PL-Rel
CGTCAGGCAGCGAACA	PL-1
CGTCAGGCAGTCCTTC	PL-0
CGTCAGGCATCCGCGA	PL-0
CGTCAGGGTACCCAAT	PL-0
CGTCAGGGTCCAGTAT	PL-0
CGTCAGGGTGTGAAAT	PL-1
CGTCAGGGTTGAGTTC	PL-1
CGTCAGGTCAACGCTA	PL-Pcd
CGTCAGGTCACCACCT	PL-3
CGTCAGGTCCACTGGG	PL-Rel
CGTCAGGTCGTTTAGG	PL-2
CGTCAGGTCTGCCAGG	PL-3
CGTCCATAGAAGCCCA	PL-0
CGTCCATAGATGGCGT	PL-2
CGTCCATAGTGGGTTG	PL-Pcd
CGTCCATAGTGTCTCA	PL-0
CGTCCATCAAATTGCC	PL-2
CGTCCATCAACTGGCC	PL-3
CGTCCATCAAGCCATT	PL-0
CGTCCATCAGCCAATT	PL-0
CGTCCATCAGTCGATT	PL-1
CGTCCATCAGTGGAGT	PL-prolif
CGTCCATCATCACGAT	PL-2
CGTCCATCATCCGCGA	PL-robo2
CGTCCATGTAAACCTC	PL-0
CGTCCATGTAACGTTC	PL-Inos
CGTCCATGTACGACCC	PL-robo2
CGTCCATGTAGATTAG	PL-1
CGTCCATGTATAAACG	PL-1
CGTCCATGTCTTTCAT	PL-0
CGTCCATGTGACTCAT	PL-Rel
CGTCCATTCAACGAAA	PL-1
CGTCCATTCAAGGCTT	PL-Inos
CGTCCATTCACATAGC	PL-Rel
CGTCCATTCAGAGACG	PL-2
CGTCTACAGAGCTGGT	PL-2
CGTCTACAGCGAGAAA	PL-3
CGTCTACAGCGTAGTG	PL-2
CGTCTACAGGCTAGGT	PL-1
CGTCTACAGTTTCCTT	PL-Inos
CGTCTACCAGCAGTTT	PL-2
CGTCTACCATAAAGGT	PL-2
CGTCTACGTATGAATG	PL-0
CGTCTACTCCAAGCCG	PL-Rel
CGTCTACTCTGCTTGC	PL-0
CGTGAGCAGAATTGTG	PL-Pcd
CGTGAGCAGACTAGAT	PL-Rel
CGTGAGCAGCAATCTC	PL-0
CGTGAGCAGCGTGTCC	PL-1
CGTGAGCAGGAGTCTG	PL-3
CGTGAGCAGGATGTAT	PL-0
CGTGAGCAGGCGACAT	CC
CGTGAGCAGGGTCGAT	PL-2
CGTGAGCAGGGTGTGT	PL-3
CGTGAGCAGGGTTCCC	PL-Rel
CGTGAGCAGTGACTCT	PL-Rel
CGTGAGCAGTTAACGA	PL-0
CGTGAGCCACCGGAAA	PL-Rel
CGTGAGCCACGTGAGA	PL-1
CGTGAGCCAGACGCTC	PL-1
CGTGAGCCATCGGACC	PL-3
CGTGAGCGTAAGCACG	PL-0
CGTGAGCGTCCGAACC	PL-1
CGTGAGCGTCGACTAT	PL-Pcd
CGTGAGCGTTGACGTT	PL-2
CGTGAGCTCTACTATC	PL-Pcd
CGTGAGCTCTCCCTGA	PL-Rel
CGTGTAAAGAAGGGTA	PL-0
CGTGTAAAGAATAGGG	PL-Lsp
CGTGTAAAGATAGGAG	PL-robo2
CGTGTAAAGCCAGTAG	PL-Rel
CGTGTAAAGTCCGTAT	PL-Rel
CGTGTAAAGTTAAGTG	PL-1
CGTGTAACAAGTCTAC	PL-0
CGTGTAACAGCAGTTT	PL-1
CGTGTAACAGCGTAAG	PL-0
CGTGTAACATCGTCGG	PL-1
CGTGTAAGTAAACGCG	PL-2
CGTGTAAGTCTAGGTT	PL-2
CGTGTAAGTTAAGAAC	PL-Pcd
CGTGTAAGTTCGGCAC	PL-0
CGTGTAAGTTGAGTTC	PL-0
CGTGTAATCAAACAAG	PL-2
CGTGTAATCAGTGCAT	PL-robo2
CGTGTAATCCCAAGTA	PL-1
CGTGTAATCCCAGGTG	PL-1
CGTGTAATCGCTTAGA	PL-robo2
CGTGTAATCGCTTGTC	PL-1
CGTGTCTCAATTGCTG	PL-1
CGTGTCTCACATTAGC	PL-Pcd
CGTGTCTCACGCTTTC	PL-Rel
CGTGTCTGTAAACCTC	PL-1
CGTGTCTGTACATGTC	PL-Rel
CGTGTCTGTCACTGGC	PL-2
CGTGTCTGTCGCTTCT	PL-1
CGTGTCTGTGTTAAGA	PL-2
CGTGTCTGTTAGAACA	PL-1
CGTGTCTGTTCACGGC	PL-Inos
CGTGTCTGTTCGCTAA	PL-3
CGTGTCTGTTGACGTT	PL-Rel
CGTGTCTTCCTCATTA	PL-Rel
CGTGTCTTCGAATCCA	PL-vir1
CGTGTCTTCGCCCTTA	PL-Pcd
CGTGTCTTCGTTACAG	PL-Pcd
CGTTAGAAGAAGCCCA	PL-0
CGTTAGAAGACTAGGC	PL-1
CGTTAGAAGCCAGTTT	PL-2
CGTTAGAAGCTTCGCG	PL-vir1
CGTTAGAAGGATCGCA	PL-robo2
CGTTAGACAGTGACAG	PL-2
CGTTAGACATCCTTGC	PL-1
CGTTAGAGTAAAGGAG	PL-Rel
CGTTAGATCACCGTAA	PL-2
CGTTAGATCCTTTACA	PL-robo2
CGTTAGATCGCAGGCT	PL-robo2
CGTTAGATCTAACTGG	PL-1
CGTTAGATCTGGAGCC	PL-2
CGTTCTGAGAAACCGC	PL-Rel
CGTTCTGAGAGGTAGA	CC
CGTTCTGAGGACAGCT	PL-2
CGTTCTGAGGAGTAGA	PL-0
CGTTCTGAGTTGAGAT	PL-Pcd
CGTTCTGCAAGCGATG	PL-2
CGTTCTGCACCTATCC	PL-2
CGTTCTGCACTGAAGG	PL-1
CGTTCTGCAGTTAACC	PL-vir1
CGTTCTGCATAAAGGT	PL-3
CGTTCTGGTAAGTTCC	PL-0
CGTTCTGGTCTCATCC	PL-0
CGTTCTGTCACCCTCA	PL-1
CGTTCTGTCGCTTAGA	PL-Rel
CGTTGGGAGACAGACC	PL-1
CGTTGGGAGACCTTTG	PL-2
CGTTGGGAGAGCTGCA	PL-Rel
CGTTGGGAGCCAGTTT	PL-Inos
CGTTGGGAGCTAAGAT	PL-1
CGTTGGGAGGCCATAG	PL-Rel
CGTTGGGAGTCCGTAT	PL-0
CGTTGGGAGTGGACGT	PL-0
CGTTGGGCAATAACGA	PL-2
CGTTGGGCAATGTTGC	PL-2
CGTTGGGCACACCGAC	PL-0
CGTTGGGCATCAGTAC	PL-Pcd
CGTTGGGCATCGATTG	PL-0
CGTTGGGCATCGGACC	PL-0
CGTTGGGCATGTAAGA	PL-0
CGTTGGGCATGTTCCC	PL-3
CGTTGGGGTAATCACC	CC
CGTTGGGGTAGATTAG	PL-1
CGTTGGGGTCATATCG	PL-1
CGTTGGGGTCCGTGAC	PL-vir1
CGTTGGGGTGCAACGA	PL-0
CGTTGGGGTGTGCCTG	PL-AMP
CGTTGGGTCGTGACAT	PL-1
CGTTGGGTCTTGTATC	PL-0
CTAACTTAGGACAGAA	PL-1
CTAACTTAGGCACATG	PL-Pcd
CTAACTTCACACCGAC	PL-1
CTAACTTCAGTTCCCT	PL-2
CTAACTTCATCGGAAG	PL-3
CTAACTTGTCAAAGAT	PL-0
CTAACTTGTCTAGTCA	PL-1
CTAACTTTCATCTGTT	PL-1
CTAACTTTCGAGAACG	PL-Lsp
CTAACTTTCTGACCTC	PL-2
CTAAGACAGAATAGGG	PL-robo2
CTAAGACAGATGTGTA	PL-robo2
CTAAGACAGATGTTAG	PL-robo2
CTAAGACAGCGATATA	PL-2
CTAAGACAGTACGACG	PL-1
CTAAGACAGTCCAGGA	PL-vir1
CTAAGACCAAGCCGTC	PL-0
CTAAGACCACCCATTC	PL-1
CTAAGACCACGAGAGT	PL-3
CTAAGACCAGCCTGTG	PL-0
CTAAGACCAGGTCCAC	PL-1
CTAAGACCATCACGTA	PL-0
CTAAGACGTAATCGTC	PL-Rel
CTAAGACGTCCGACGT	PL-Rel
CTAAGACGTTGAACTC	PL-vir1
CTAAGACTCATCGATG	PL-2
CTAAGACTCATTTGGG	PL-0
CTAAGACTCCGGCACA	PL-Rel
CTAAGACTCCTATTCA	PL-2
CTAATGGAGGGATGGG	PL-Rel
CTAATGGAGTAGCCGA	PL-Lsp
CTAATGGAGTTGTAGA	PL-3
CTAATGGCAAGTCATC	PL-0
CTAATGGCACATCTTT	PL-2
CTAATGGCACGCATCG	PL-Inos
CTAATGGCATGTTGAC	PL-1
CTAATGGGTCTCAACA	PL-1
CTAATGGGTCTCACCT	PL-1
CTAATGGGTCTGCGGT	PL-0
CTAATGGGTGATAAGT	PL-1
CTAATGGGTGCACGAA	PL-2
CTAATGGGTTCGTGAT	PL-AMP
CTAATGGTCCATGCTC	PL-Inos
CTAATGGTCTGCGACG	PL-Rel
CTAATGGTCTGTTTGT	PL-Rel
CTACACCAGAGGTTGC	PL-1
CTACACCAGCGTGAAC	PL-2
CTACACCAGGCAGGTT	PL-0
CTACACCCACAGACTT	PL-1
CTACACCCATGCAACT	PL-3
CTACACCCATTACCTT	PL-Rel
CTACACCGTAAAGGAG	PL-Rel
CTACACCGTATATCCG	PL-0
CTACACCGTCCAAGTT	PL-3
CTACACCGTGATGTCT	PL-Rel
CTACATTAGAGGACGG	PL-0
CTACATTAGATAGTCA	PL-1
CTACATTAGGTACTCT	PL-2
CTACATTAGTACGATA	PL-3
CTACATTAGTCATGCT	PL-3
CTACATTCACTTCTGC	PL-Inos
CTACATTCAGTGACAG	PL-0
CTACATTGTAAAGGAG	PL-0
CTACATTGTAGGAGTC	PL-Rel
CTACATTGTCTGATTG	PL-0
CTACATTGTGAGGCTA	PL-1
CTACATTGTGTGCCTG	PL-1
CTACATTGTGTGTGCC	PL-1
CTACATTGTTCAGTAC	PL-1
CTACATTTCCGTTGCT	PL-0
CTACCCAAGACGCTTT	PL-3
CTACCCAAGATGTCGG	PL-0
CTACCCAAGGACACCA	PL-Pcd
CTACCCAAGGCCCGTT	PL-0
CTACCCACAAAGTGCG	PL-0
CTACCCACAACTGCGC	PL-1
CTACCCACAGTATAAG	PL-Lsp
CTACCCACATGCCCGA	PL-Rel
CTACCCAGTACTCTCC	PL-1
CTACCCAGTCAACATC	PL-0
CTACCCAGTCAGAATA	PL-robo2
CTACCCAGTCCATGAT	PL-0
CTACCCAGTTACTGAC	PL-1
CTACCCAGTTATCCGA	PL-0
CTACCCATCCACGAAT	PL-2
CTACCCATCCTTGACC	PL-Rel
CTACCCATCCTTGGTC	PL-AMP
CTACCCATCGGTGTTA	PL-0
CTACGTCAGGGAAACA	PL-1
CTACGTCAGTTGAGAT	PL-robo2
CTACGTCCACCAGGTC	PL-3
CTACGTCCACGGCCAT	PL-2
CTACGTCCAGGCGATA	PL-Lsp
CTACGTCCAGTCTTCC	PL-0
CTACGTCGTAGCGTAG	PL-Pcd
CTACGTCGTTGGTAAA	PL-Rel
CTACGTCTCAGGCCCA	PL-1
CTACGTCTCGAGGTAG	PL-Rel
CTACGTCTCTTGTTTG	PL-Lsp
CTAGAGTAGGACAGCT	PL-1
CTAGAGTAGGCGTACA	PL-Inos
CTAGAGTAGGGAAACA	PL-0
CTAGAGTCAAGTCTGT	PL-prolif
CTAGAGTCAATCTGCA	PL-1
CTAGAGTCAGGGAGAG	PL-vir1
CTAGAGTCATCTATGG	PL-robo2
CTAGAGTGTATAGGGC	PL-0
CTAGAGTGTGACGCCT	PL-Lsp
CTAGAGTTCACCCGAG	PL-2
CTAGAGTTCATGCATG	PL-2
CTAGAGTTCTCGTTTA	PL-0
CTAGAGTTCTTACCTA	PL-2
CTAGAGTTCTTCAACT	PL-vir1
CTAGCCTAGAGATGAG	PL-Rel
CTAGCCTAGGATGGTC	PL-3
CTAGCCTAGGCTATCT	PL-Rel
CTAGCCTAGGTGCTTT	PL-robo2
CTAGCCTAGTTCGCAT	PL-robo2
CTAGCCTCACCATCCT	PL-vir1
CTAGCCTCATGCAATC	PL-vir1
CTAGCCTCATGTCCTC	PL-0
CTAGCCTCATTTCAGG	PL-1
CTAGCCTGTGCGGTAA	PL-0
CTAGCCTGTTTAGGAA	PL-2
CTAGCCTTCAGCTGGC	PL-robo2
CTAGCCTTCCTTGCCA	PL-2
CTAGTGAAGACCTAGG	PL-2
CTAGTGAAGACTTTCG	PL-0
CTAGTGAAGATGTTAG	PL-0
CTAGTGAAGCAACGGT	PL-Rel
CTAGTGAAGGAATGGA	PL-Inos
CTAGTGACAGACAGGT	PL-0
CTAGTGACATCTCCCA	PL-0
CTAGTGACATGAAGTA	PL-0
CTAGTGACATGCATGT	PL-1
CTAGTGAGTTAAGACA	PL-0
CTAGTGAGTTCAGTAC	PL-2
CTAGTGAGTTCCCTTG	PL-Rel
CTAGTGATCATAACCG	PL-Rel
CTAGTGATCCAAAGTC	PL-3
CTAGTGATCCAAGCCG	PL-robo2
CTAGTGATCGTCCAGG	PL-1
CTAGTGATCTGCCCTA	PL-2
CTCACACAGAGCTGGT	PL-1
CTCACACAGAGGTTAT	PL-Pcd
CTCACACAGATCGGGT	PL-2
CTCACACAGCCACGCT	PL-Lsp
CTCACACAGGAATGGA	PL-Pcd
CTCACACCAAGCCGCT	PL-0
CTCACACCAGTGGAGT	PL-robo2
CTCACACGTAGGCATG	PL-Inos
CTCACACGTCAAACTC	PL-1
CTCACACGTCCGAGTC	PL-0
CTCACACTCAAACGGG	PL-Pcd
CTCACACTCAGCTCTC	PL-Inos
CTCAGAAAGACGCTTT	PL-1
CTCAGAAAGCTGCAAG	PL-1
CTCAGAAAGGAGCGTT	CC
CTCAGAAAGGTGCACA	PL-Rel
CTCAGAACAATGGACG	PL-0
CTCAGAACACATCCAA	PL-2
CTCAGAACACCATCCT	PL-Rel
CTCAGAACACGTCTCT	PL-Lsp
CTCAGAACACTGTCGG	PL-Rel
CTCAGAACATCGATGT	PL-0
CTCAGAAGTAGTACCT	PL-Rel
CTCAGAATCCAGAAGG	PL-0
CTCAGAATCCTCGCAT	PL-vir1
CTCAGAATCCTGTACC	PL-1
CTCAGAATCCTTGGTC	PL-1
CTCAGAATCGACGGAA	PL-robo2
CTCAGAATCGTATCAG	PL-1
CTCATTAAGCCATCGC	PL-0
CTCATTAAGGAGTACC	PL-0
CTCATTAAGTCACGCC	PL-2
CTCATTACACGACGAA	PL-2
CTCATTACAGCTCGCA	PL-0
CTCATTACATATGCTG	PL-vir1
CTCATTACATTTCACT	PL-3
CTCATTAGTACAGCAG	PL-0
CTCATTAGTAGCACGA	PL-0
CTCATTAGTAGCGCTC	PL-ImpL2
CTCATTAGTAGGACAC	PL-2
CTCATTAGTCGAACAG	PL-1
CTCATTATCAACACCA	PL-2
CTCATTATCAGGTTCA	PL-0
CTCATTATCCGCAAGC	PL-vir1
CTCATTATCGCCCTTA	PL-2
CTCATTATCGGTGTTA	PL-robo2
CTCATTATCGTCGTTC	PL-vir1
CTCCTAGAGACAATAC	PL-3
CTCCTAGAGCAATCTC	PL-1
CTCCTAGAGGTTACCT	PL-0
CTCCTAGAGTAATCCC	PL-1
CTCCTAGCAATCCAAC	PL-1
CTCCTAGCAATGCCAT	PL-0
CTCCTAGCAGCCTGTG	PL-robo2
CTCCTAGCATATGCTG	PL-2
CTCCTAGGTAGCGTGA	PL-1
CTCCTAGGTCCAGTAT	PL-0
CTCCTAGGTCCCTTGT	PL-1
CTCCTAGGTCGAAAGC	CC
CTCCTAGGTGAAGGCT	PL-3
CTCCTAGTCCACGTGG	PL-1
CTCCTAGTCGACCAGC	PL-Pcd
CTCCTAGTCGTAGGAG	PL-1
CTCGAAAAGATAGGAG	PL-1
CTCGAAAAGATCCTGT	PL-3
CTCGAAAAGGACCACA	PL-2
CTCGAAAAGGCAATTA	PL-robo2
CTCGAAACACCACGTG	PL-1
CTCGAAACACTGCCAG	PL-robo2
CTCGAAACAGTATGCT	PL-Pcd
CTCGAAAGTAAGAGGA	PL-Pcd
CTCGAAAGTACAGTGG	PL-0
CTCGAAAGTCAATACC	PL-Rel
CTCGAAAGTCAGATAA	PL-vir1
CTCGAAAGTGAGTGAC	PL-vir1
CTCGAAAGTGTCGCTG	PL-1
CTCGAAAGTTCGAATC	PL-0
CTCGAAAGTTTGTTGG	PL-Rel
CTCGAAATCGTTTGCC	PL-Lsp
CTCGAAATCTATCCTA	PL-3
CTCGAAATCTCTTGAT	PL-Rel
CTCGAAATCTTGAGGT	PL-0
CTCGAGGAGCGAGAAA	PL-0
CTCGAGGAGCTCCCAG	PL-0
CTCGAGGAGCTGAACG	PL-Pcd
CTCGAGGAGTAGCGGT	PL-2
CTCGAGGAGTGTGAAT	PL-ImpL2
CTCGAGGAGTTAGCGG	PL-2
CTCGAGGCAAGCCGCT	PL-3
CTCGAGGCACCACCAG	PL-Rel
CTCGAGGCATCCAACA	PL-3
CTCGAGGGTGTGCGTC	PL-Inos
CTCGAGGTCGACGGAA	PL-3
CTCGAGGTCTTGACGA	PL-Rel
CTCGAGGTCTTGTACT	PL-2
CTCGGAGAGATGCGAC	PL-vir1
CTCGGAGAGATGTAAC	PL-robo2
CTCGGAGAGTTAACGA	PL-1
CTCGGAGCAAAGGAAG	PL-robo2
CTCGGAGCAAGCCCAC	PL-2
CTCGGAGCACAGGTTT	PL-1
CTCGGAGCACATTTCT	PL-2
CTCGGAGCACCATGTA	PL-0
CTCGGAGCACCTCGTT	PL-1
CTCGGAGCACTAGTAC	PL-0
CTCGGAGCATGACATC	PL-Pcd
CTCGGAGGTAGGACAC	PL-0
CTCGGAGGTCTAGGTT	PL-Rel
CTCGGAGTCAGATAAG	PL-2
CTCGGAGTCAGTTAGC	PL-Pcd
CTCGGAGTCCACGAAT	PL-2
CTCGGAGTCCTAAGTG	PL-2
CTCGGAGTCGGCGGTT	PL-robo2
CTCGGAGTCTACCAGA	PL-0
CTCGGGAAGACGACGT	PL-0
CTCGGGAAGATCCGAG	PL-1
CTCGGGAAGCACAGGT	PL-2
CTCGGGAAGCGCTCCA	PL-Pcd
CTCGGGAAGGCTAGGT	PL-2
CTCGGGAAGGTGACCA	PL-robo2
CTCGGGAAGTTTAGGA	PL-1
CTCGGGACAATTCCTT	PL-2
CTCGGGACACAGACAG	PL-2
CTCGGGACAGTCACTA	PL-Rel
CTCGGGACATTTGCTT	PL-2
CTCGGGAGTAGCTTGT	PL-1
CTCGGGATCCGGGTGT	PL-0
CTCGGGATCGTTACGA	PL-1
CTCGGGATCGTTTAGG	PL-1
CTCGTACAGATCCCAT	PL-2
CTCGTACAGGCGCTCT	PL-Pcd
CTCGTACAGGTGATTA	PL-3
CTCGTACAGTGATCGG	PL-2
CTCGTACCAAAGTCAA	PL-1
CTCGTACCAATCCAAC	PL-1
CTCGTACCACGGTGTC	PL-2
CTCGTACCAGCCACCA	PL-0
CTCGTACCAGGAACGT	PL-3
CTCGTACCAGGAATGC	PL-0
CTCGTACCATATGCTG	PL-0
CTCGTACGTATAGGGC	PL-Rel
CTCGTACGTCCAACTA	PL-Rel
CTCGTACGTTGTGGAG	PL-Rel
CTCGTACTCCGAACGC	PL-0
CTCGTACTCGACCAGC	PL-vir1
CTCGTACTCTACTCAT	PL-0
CTCGTACTCTTCAACT	PL-0
CTCGTCAAGCGTAGTG	PL-Rel
CTCGTCAAGCTGCGAA	PL-0
CTCGTCAAGGCGACAT	PL-Lsp
CTCGTCACAATGCCAT	PL-0
CTCGTCACAATGGACG	PL-1
CTCGTCACATCCGTGG	PL-2
CTCGTCACATCTACGA	PL-0
CTCGTCATCAAGGCTT	PL-1
CTCGTCATCAGCACAT	PL-2
CTCGTCATCGCGTAGC	PL-Pcd
CTCGTCATCTTGTATC	PL-2
CTCTAATCAAGGTTCT	PL-1
CTCTAATCAATCTGCA	PL-Pcd
CTCTAATCACCTCGGA	PL-robo2
CTCTAATCACGGTAAG	PL-2
CTCTAATCATGACGGA	PL-2
CTCTAATGTAAACACA	PL-2
CTCTAATGTCCGCTGA	PL-Rel
CTCTAATGTGAGTATA	PL-Pcd
CTCTAATTCCCTTGCA	PL-2
CTCTAATTCCTTAATC	PL-Rel
CTCTAATTCGGCCGAT	PL-1
CTCTAATTCTAACGGT	PL-1
CTCTAATTCTCCAACC	PL-0
CTCTAATTCTTATCTG	PL-Rel
CTCTACGAGAAACCGC	PL-1
CTCTACGAGATCCCAT	PL-robo2
CTCTACGAGATGCCTT	PL-1
CTCTACGAGTCGTACT	PL-1
CTCTACGAGTTTCCTT	PL-0
CTCTACGCAAAGGAAG	PL-2
CTCTACGCAAGACACG	PL-Rel
CTCTACGCACAACGTT	PL-2
CTCTACGCAGTTTACG	PL-0
CTCTACGGTATATGGA	PL-2
CTCTACGGTGCCTGTG	PL-0
CTCTACGGTGTGAAAT	PL-2
CTCTACGGTTCAGGCC	PL-0
CTCTACGTCAAACCAC	PL-1
CTCTACGTCAGAAATG	PL-0
CTCTACGTCGGAGCAA	PL-1
CTCTACGTCGTTTATC	PL-Rel
CTCTGGTAGAGTTGGC	PL-robo2
CTCTGGTAGCGAAGGG	PL-0
CTCTGGTAGCGCTTAT	PL-Inos
CTCTGGTAGCGTGTCC	PL-robo2
CTCTGGTAGCTGTCTA	PL-0
CTCTGGTAGGACAGAA	PL-3
CTCTGGTAGGCTAGCA	PL-1
CTCTGGTAGTAGCGGT	PL-0
CTCTGGTAGTTCGATC	PL-3
CTCTGGTCAAACTGTC	PL-vir1
CTCTGGTCACATGGGA	PL-vir1
CTCTGGTCACCGAAAG	PL-3
CTCTGGTCACGGTAAG	PL-robo2
CTCTGGTCAGCCAATT	PL-0
CTCTGGTCAGGGTACA	PL-1
CTCTGGTCAGTCGTGC	PL-1
CTCTGGTGTCCTCCAT	PL-Rel
CTCTGGTGTGCGATAG	PL-Rel
CTCTGGTGTGTAATGA	PL-2
CTCTGGTGTTGGTGGA	PL-1
CTCTGGTTCCCTCTTT	PL-Rel
CTCTGGTTCCGTCATC	PL-1
CTCTGGTTCGCTGATA	PL-Rel
CTCTGGTTCTCAACTT	PL-Rel
CTGAAACAGAGACTAT	PL-robo2
CTGAAACAGCACCGCT	PL-Rel
CTGAAACAGTGAACAT	PL-0
CTGAAACAGTGTGGCA	PL-robo2
CTGAAACCAAGGACAC	PL-Rel
CTGAAACCAGGTTTCA	PL-3
CTGAAACCAGTATGCT	PL-Pcd
CTGAAACCATCCGCGA	PL-Rel
CTGAAACTCAACACCA	PL-3
CTGAAACTCACATACG	PL-Inos
CTGAAACTCATGTAGC	PL-1
CTGAAACTCCAAAGTC	PL-2
CTGAAACTCCTCAATT	PL-Rel
CTGAAACTCGCAAGCC	PL-robo2
CTGAAACTCGGAATCT	PL-1
CTGAAACTCGGGAGTA	PL-Rel
CTGAAACTCTTGCAAG	PL-Inos
CTGAAGTAGATATGGT	PL-Pcd
CTGAAGTAGCTCCTTC	PL-robo2
CTGAAGTAGGACTGGT	PL-3
CTGAAGTAGGTGTTAA	PL-vir1
CTGAAGTAGTCAAGGC	PL-0
CTGAAGTCAATAGCGG	PL-robo2
CTGAAGTCAGACAAAT	PL-0
CTGAAGTCAGCGTTCG	PL-Inos
CTGAAGTCATCCCACT	CC
CTGAAGTGTCAATACC	PL-3
CTGAAGTGTGTGTGCC	PL-1
CTGAAGTGTTCGTGAT	PL-2
CTGAAGTGTTGCCTCT	PL-Rel
CTGAAGTTCAAAGACA	PL-2
CTGAAGTTCAATACCG	PL-0
CTGAAGTTCGGACAAG	PL-2
CTGATAGAGCACACAG	PL-robo2
CTGATAGCACCAGCAC	PL-0
CTGATAGCACTCGACG	PL-0
CTGATAGCATCTATGG	PL-Inos
CTGATAGCATGCCCGA	PL-0
CTGATAGCATGTCTCC	PL-Lsp
CTGATAGGTAGCGTAG	PL-robo2
CTGATAGGTATATCCG	PL-1
CTGATAGGTATGCTTG	PL-vir1
CTGATAGGTCATTAGC	PL-2
CTGATAGGTGGCGAAT	PL-Rel
CTGATAGGTTACGCGC	PL-Rel
CTGATAGGTTAGAACA	PL-Rel
CTGATAGGTTCCACAA	PL-1
CTGATAGTCAGCACAT	PL-Inos
CTGATAGTCCGGGTGT	PL-Inos
CTGATAGTCGAACTGT	PL-3
CTGATAGTCTTCGAGA	PL-3
CTGATCCAGTATGACA	PL-0
CTGATCCCAAGCCGCT	PL-Rel
CTGATCCCAGAGCCAA	PL-3
CTGATCCCATCGTCGG	PL-0
CTGATCCCATCTATGG	PL-2
CTGATCCCATTCTCAT	PL-Rel
CTGATCCGTGCCTGCA	PL-Pcd
CTGATCCGTTTGGCGC	PL-1
CTGATCCTCAAGATCC	PL-1
CTGATCCTCAGTACGT	PL-Rel
CTGATCCTCCGTAGGC	PL-Rel
CTGATCCTCTACGAGT	PL-Lsp
CTGATCCTCTGGTGTA	PL-0
CTGCCTACACATGACT	PL-Rel
CTGCCTACACCTATCC	PL-Pcd
CTGCCTACACTTCGAA	PL-0
CTGCCTACAGTCTTCC	PL-vir1
CTGCCTACATCGACGC	PL-Pcd
CTGCCTAGTCAGGACA	PL-1
CTGCCTAGTCGCGAAA	PL-2
CTGCCTAGTTAAGGGC	PL-2
CTGCCTAGTTCCATGA	PL-1
CTGCCTAGTTGCGTTA	PL-3
CTGCCTATCAGTCCCT	PL-Rel
CTGCCTATCATGCATG	PL-3
CTGCCTATCGGCATCG	PL-2
CTGCCTATCGTAGGTT	PL-Inos
CTGCCTATCTAACTGG	PL-0
CTGCCTATCTAACTTC	PL-robo2
CTGCCTATCTTGTACT	PL-Rel
CTGCGGAAGCCGTCGT	PL-Pcd
CTGCGGAAGCTAAGAT	PL-Rel
CTGCGGAAGGCGCTCT	PL-1
CTGCGGAAGTACCGGA	PL-0
CTGCGGAAGTGCGTGA	PL-0
CTGCGGACAATGTAAG	PL-3
CTGCGGACACCACGTG	PL-0
CTGCGGACATAAAGGT	PL-2
CTGCGGACATCCGCGA	PL-2
CTGCGGACATGCGCAC	PL-3
CTGCGGACATTCTTAC	PL-Rel
CTGCGGAGTCGGCATC	PL-3
CTGCGGAGTGGACGAT	PL-3
CTGCGGAGTGTGACGA	PL-2
CTGCGGATCACGAAGG	PL-2
CTGCGGATCAGAGACG	PL-2
CTGCGGATCCAAACAC	PL-Rel
CTGCGGATCCGCGCAA	PL-Inos
CTGCGGATCTCATTCA	PL-Rel
CTGCGGATCTGCTTGC	PL-robo2
CTGCTGTAGGATATAC	PL-0
CTGCTGTAGTCTTGCA	PL-1
CTGCTGTCAAGGTGTG	PL-2
CTGCTGTCACGGCTAC	PL-Rel
CTGCTGTCAGCTATTG	PL-0
CTGCTGTCAGGGCATA	PL-2
CTGCTGTCATCACGAT	PL-Rel
CTGCTGTGTCACACGC	PL-0
CTGCTGTGTCCATCCT	PL-Lsp
CTGCTGTGTCCGACGT	PL-robo2
CTGCTGTGTTAAGGGC	PL-Rel
CTGCTGTGTTGTACAC	PL-Rel
CTGCTGTTCACTTCAT	PL-0
CTGCTGTTCAGCTTAG	PL-0
CTGCTGTTCCCAACGG	PL-2
CTGCTGTTCCGTCAAA	PL-Rel
CTGCTGTTCTATCGCC	PL-0
CTGGTCTAGTCTCCTC	PL-1
CTGGTCTGTTGTCTTT	PL-0
CTGGTCTTCAAGGCTT	PL-0
CTGGTCTTCGACAGCC	PL-ImpL2
CTGGTCTTCTTACCTA	PL-Rel
CTGTGCTAGAAACGCC	PL-2
CTGTGCTAGACTAAGT	PL-Inos
CTGTGCTAGGATGGAA	PL-1
CTGTGCTAGGGAAACA	PL-0
CTGTGCTCAAATACAG	PL-2
CTGTGCTCACCATCCT	PL-vir1
CTGTGCTCACCGAAAG	PL-0
CTGTGCTCATGCCACG	PL-Lsp
CTGTGCTCATTCTCAT	PL-0
CTGTGCTGTAAGAGGA	PL-0
CTGTGCTGTACATGTC	PL-0
CTGTGCTGTATTAGCC	PL-robo2
CTGTGCTGTCCGAACC	PL-0
CTGTGCTGTCTTGATG	PL-0
CTGTGCTGTTACGCGC	PL-1
CTGTGCTGTTCGTTGA	PL-1
CTGTGCTTCTCGTATT	PL-0
CTGTTTAAGATCGATA	PL-2
CTGTTTAAGCAATCTC	PL-0
CTGTTTAAGGGCATGT	PL-0
CTGTTTACAAGCGTAG	PL-vir1
CTGTTTACACAGGAGT	PL-1
CTGTTTACACCAGATT	PL-1
CTGTTTACACGAAACG	PL-2
CTGTTTACACGTTGGC	PL-2
CTGTTTACATATACCG	PL-robo2
CTGTTTACATTTCAGG	PL-3
CTGTTTAGTAGAAGGA	PL-Rel
CTGTTTAGTCACCCAG	PL-1
CTGTTTAGTCGAACAG	PL-2
CTGTTTAGTCTGATCA	PL-3
CTGTTTAGTGAGGCTA	PL-3
CTGTTTAGTGGACGAT	PL-Lsp
CTGTTTAGTGTGCCTG	PL-1
CTTAACTAGAGGTAGA	PL-Lsp
CTTAACTAGGGTCTCC	PL-robo2
CTTAACTCAAGCCGTC	PL-1
CTTAACTCACAGGAGT	PL-3
CTTAACTCACATCTTT	PL-2
CTTAACTCACCAGTTA	PL-prolif
CTTAACTCACCCATGG	PL-0
CTTAACTCAGGTCCAC	PL-2
CTTAACTCAGTAGAGC	PL-3
CTTAACTCAGTCCTTC	PL-2
CTTAACTCATACTACG	PL-robo2
CTTAACTCATATACCG	PL-1
CTTAACTGTACTTGAC	PL-Rel
CTTAACTGTAGAGTGC	PL-robo2
CTTAACTGTGTTGGGA	PL-0
CTTAACTGTTAAGATG	PL-Rel
CTTAACTTCACCGTAA	PL-1
CTTAACTTCAGAGACG	PL-robo2
CTTAACTTCCCGGATG	PL-robo2
CTTAACTTCGCACTCT	PL-vir1
CTTAACTTCTTCTGGC	PL-2
CTTACCGAGCCAACAG	PL-1
CTTACCGAGTCCATAC	PL-0
CTTACCGCAAACGCGA	PL-Pcd
CTTACCGCACAGGTTT	PL-Rel
CTTACCGCACATTAGC	PL-0
CTTACCGCACATTCGA	PL-0
CTTACCGCACCCAGTG	PL-0
CTTACCGCAGACGCCT	PL-0
CTTACCGGTACAGACG	PL-3
CTTACCGGTAGGGTAC	PL-0
CTTACCGGTCGAGATG	PL-1
CTTACCGGTCTCAACA	PL-1
CTTACCGTCCAAGCCG	PL-2
CTTACCGTCCCTTGCA	PL-Lsp
CTTACCGTCGTTGACA	PL-Rel
CTTAGGAAGATCACGG	PL-0
CTTAGGAAGCTGTCTA	PL-1
CTTAGGAAGTAGCCGA	PL-3
CTTAGGACACCGTTGG	PL-vir1
CTTAGGACACTCGACG	PL-0
CTTAGGACAGACACTT	PL-0
CTTAGGACAGCGAACA	PL-2
CTTAGGACAGTCCTTC	PL-0
CTTAGGACATCCCACT	PL-3
CTTAGGAGTAACGCGA	PL-1
CTTAGGAGTACTTAGC	PL-2
CTTAGGAGTATCACCA	PL-3
CTTAGGAGTCACTGGC	PL-robo2
CTTAGGAGTGCAGGTA	PL-0
CTTAGGAGTGGTCCGT	PL-vir1
CTTAGGATCCTCAATT	PL-Inos
CTTAGGATCGCCAAAT	PL-1
CTTAGGATCGCGGATC	PL-0
CTTAGGATCTTCGAGA	PL-0
CTTCTCTAGACAATAC	PL-2
CTTCTCTAGCGAAGGG	PL-2
CTTCTCTAGGGATGGG	PL-2
CTTCTCTAGTGGTAAT	PL-1
CTTCTCTCAAACGCGA	PL-Inos
CTTCTCTCAAGCCTAT	PL-1
CTTCTCTCATGCCTAA	PL-2
CTTCTCTCATGTAAGA	PL-0
CTTCTCTGTACTCTCC	PL-0
CTTCTCTGTTAAGTAG	PL-1
CTTCTCTTCAAGAAGT	PL-robo2
CTTCTCTTCATAAAGG	PL-0
CTTCTCTTCGCGTTTC	PL-2
CTTCTCTTCGGCGCTA	PL-vir1
CTTCTCTTCGGTGTTA	PL-2
CTTCTCTTCGTAGGAG	PL-Rel
CTTCTCTTCTGCGTAA	PL-3
CTTGGCTAGCACCGCT	PL-2
CTTGGCTAGGCCCTCA	PL-Pcd
CTTGGCTCAAGCCGTC	PL-1
CTTGGCTCAGAGTGTG	PL-1
CTTGGCTCAGCGTTCG	PL-0
CTTGGCTCATCTGGTA	PL-0
CTTGGCTGTCACTTCC	PL-Pcd
CTTGGCTGTCCGAGTC	PL-AMP
CTTGGCTGTGTGCCTG	PL-0
CTTGGCTTCACCAGGC	PL-2
CTTGGCTTCCCTGACT	PL-0
CTTGGCTTCTCTAAGG	PL-3
CTTTGCGAGATCACGG	PL-Rel
CTTTGCGAGTCGTTTG	PL-0
CTTTGCGAGTTGAGAT	PL-0
CTTTGCGCAAATCCGT	PL-vir1
CTTTGCGCACAAGACG	PL-2
CTTTGCGCAGATGGGT	PL-2
CTTTGCGCATGCATGT	PL-Rel
CTTTGCGCATGCTAGT	PL-0
CTTTGCGGTAAAGTCA	PL-2
CTTTGCGGTATAATGG	PL-Rel
CTTTGCGGTCTCATCC	PL-2
CTTTGCGGTGCAACGA	PL-1
CTTTGCGGTGCCTTGG	PL-0
CTTTGCGGTTATTCTC	PL-Rel
CTTTGCGTCAAACCAC	PL-3
CTTTGCGTCAAGAAGT	PL-2
CTTTGCGTCAAGATCC	PL-Pcd
CTTTGCGTCCAGTAGT	PL-2
CTTTGCGTCTTGGGTA	PL-1
GAAACTCAGCGCCTCA	PL-1
GAAACTCAGGCCATAG	PL-0
GAAACTCAGTGGTAGC	PL-3
GAAACTCCAATCAGAA	PL-Inos
GAAACTCCACAAGACG	PL-1
GAAACTCGTCATTAGC	PL-2
GAAACTCGTCGCATCG	PL-robo2
GAAACTCGTCTACCTC	PL-0
GAAACTCTCAAACGGG	PL-prolif
GAAACTCTCAACGCTA	PL-vir1
GAAACTCTCATACGGT	PL-robo2
GAAACTCTCATGCTCC	PL-2
GAAATGAAGAGACGAA	PL-2
GAAATGAAGAGCTGGT	PL-0
GAAATGAAGGATTCGG	PL-1
GAAATGACACATCCGG	PL-0
GAAATGACACCAACCG	PL-Rel
GAAATGACATGGATGG	PL-vir1
GAAATGACATTTGCCC	PL-0
GAAATGAGTCCAGTTA	PL-0
GAAATGAGTCGGCACT	PL-Lsp
GAAATGAGTGGCAAAC	PL-Inos
GAAATGAGTGGTCTCG	PL-0
GAAATGATCAAAGTAG	PL-Rel
GAAATGATCAGCCTAA	PL-Rel
GAAATGATCCGCTGTT	PL-3
GAAATGATCCGTCATC	PL-3
GAAATGATCTCGTTTA	PL-1
GAAATGATCTGACCTC	PL-2
GAAATGATCTTCGGTC	PL-0
GAACATCAGAGGACGG	PL-2
GAACATCAGCACCGCT	PL-0
GAACATCAGGTGCAAC	PL-2
GAACATCAGTAGGTGC	PL-vir1
GAACATCAGTGGAGAA	PL-Rel
GAACATCCATGGTAGG	PL-1
GAACATCCATTCTCAT	PL-Inos
GAACATCGTAACGTTC	PL-2
GAACATCGTAGAGCTG	PL-robo2
GAACATCGTCTCATCC	PL-Lsp
GAACATCGTGCGATAG	PL-2
GAACATCGTTCTGAAC	PL-2
GAACATCTCACGAAGG	PL-Lsp
GAACATCTCCTAGGGC	PL-0
GAACATCTCGTAGGAG	PL-0
GAACATCTCTCCGGTT	PL-1
GAACATCTCTGCCCTA	PL-Pcd
GAACCTAAGAGTTGGC	PL-2
GAACCTAAGGTAGCCA	PL-1
GAACCTAAGTAAGTAC	PL-Inos
GAACCTAAGTACCGGA	PL-robo2
GAACCTACAAGCGTAG	PL-0
GAACCTACATCTCGCT	PL-Lsp
GAACCTAGTATAGTAG	PL-1
GAACCTAGTCACCTAA	PL-1
GAACCTAGTCTGATTG	PL-2
GAACCTAGTCTTCTCG	PL-1
GAACCTAGTGACAAAT	PL-Rel
GAACCTAGTGCACTTA	PL-2
GAACCTAGTGCCTTGG	PL-2
GAACCTATCAGAGGTG	PL-1
GAACCTATCAGTGTTG	PL-Rel
GAACCTATCATGTCCC	PL-2
GAACCTATCCGCAGTG	PL-0
GAACCTATCGCCGTGA	PL-2
GAACGGAAGACTCGGA	PL-vir1
GAACGGAAGAGACGAA	PL-robo2
GAACGGAAGAGTGACC	PL-0
GAACGGAAGCTAGCCC	PL-0
GAACGGAAGTACGTTC	PL-0
GAACGGAAGTTACCCA	PL-3
GAACGGACAATCCAAC	PL-1
GAACGGAGTACCAGTT	PL-robo2
GAACGGAGTAGCTCCG	PL-robo2
GAACGGAGTCCGACGT	PL-3
GAACGGAGTCGAATCT	PL-robo2
GAACGGAGTGATGTGG	PL-2
GAACGGAGTTCATGGT	PL-Rel
GAACGGAGTTGCGCAC	PL-robo2
GAACGGATCCAAACTG	PL-1
GAACGGATCCAGATCA	PL-1
GAACGGATCCGCGTTT	PL-AMP
GAACGGATCGACAGCC	PL-0
GAACGGATCGTTACGA	PL-Rel
GAACGGATCTACCAGA	PL-vir1
GAACGGATCTAGCACA	PL-0
GAACGGATCTGCGTAA	PL-Pcd
GAACGGATCTGGTGTA	PL-1
GAAGCAGAGACGCTTT	PL-Rel
GAAGCAGAGAGACTAT	PL-Rel
GAAGCAGAGCGGATCA	PL-Pcd
GAAGCAGAGGGATCTG	PL-0
GAAGCAGCACATGGGA	PL-2
GAAGCAGCACGAGGTA	PL-robo2
GAAGCAGCAGTCGATT	PL-3
GAAGCAGGTATTAGCC	PL-2
GAAGCAGGTTCACGGC	PL-1
GAAGCAGGTTGCTCCT	PL-Inos
GAAGCAGTCAGCTCGG	PL-1
GAAGCAGTCCCATTAT	PL-2
GAAGCAGTCCTGTAGA	PL-3
GAAGCAGTCGGTGTCG	PL-Inos
GAAGCAGTCTTAGCCC	PL-0
GAATAAGAGAGCTGGT	PL-0
GAATAAGAGTACCGGA	PL-0
GAATAAGAGTCTCGGC	PL-3
GAATAAGCAACTTGAC	PL-AMP
GAATAAGCAAGCGTAG	PL-1
GAATAAGCAATAGCGG	PL-3
GAATAAGCAATGTAAG	PL-0
GAATAAGCACTGTCGG	PL-2
GAATAAGCATCGGGTC	PL-2
GAATAAGCATGCGCAC	PL-vir1
GAATAAGCATGGGAAC	PL-vir1
GAATAAGCATGGTAGG	PL-1
GAATAAGTCCAGAAGG	PL-2
GAATAAGTCCGTCATC	PL-2
GAATAAGTCGGAGGTA	PL-robo2
GAATGAAAGATGCCTT	PL-Rel
GAATGAAAGGCCGAAT	PL-0
GAATGAAAGGCTAGCA	PL-0
GAATGAAAGTACACCT	PL-ImpL2
GAATGAAAGTGGGCTA	PL-2
GAATGAACACTCAGGC	PL-1
GAATGAACATGGGACA	PL-3
GAATGAACATGTCCTC	PL-2
GAATGAAGTACTTAGC	PL-Inos
GAATGAAGTCCAGTTA	PL-robo2
GAATGAAGTGAGCGAT	PL-3
GAATGAAGTGATGTGG	PL-1
GAATGAAGTTAAAGAC	PL-Pcd
GAATGAATCAGCGACC	PL-Inos
GAATGAATCCACGACG	PL-1
GAATGAATCTGTCAAG	PL-Rel
GAATGAATCTTCGGTC	PL-Rel
GACACGCAGACCTTTG	PL-2
GACACGCAGCAGGCTA	PL-1
GACACGCAGCATCATC	PL-3
GACACGCAGGAATTAC	PL-0
GACACGCAGGCGATAC	PL-2
GACACGCAGGTACTCT	PL-Rel
GACACGCCATCCCATC	PL-0
GACACGCCATGTCCTC	PL-3
GACACGCCATTATCTC	PL-3
GACACGCGTATAATGG	PL-0
GACACGCGTCGCTTCT	PL-1
GACACGCGTGGCAAAC	PL-Rel
GACACGCTCCTAGTGA	PL-1
GACACGCTCTATGTGG	PL-0
GACACGCTCTGGTGTA	PL-0
GACAGAGAGAGTGACC	PL-2
GACAGAGAGATGCGAC	PL-0
GACAGAGAGGACAGAA	PL-2
GACAGAGAGGATGCGT	PL-1
GACAGAGCAGACAGGT	PL-0
GACAGAGGTATGCTTG	PL-2
GACAGAGGTCCCTTGT	PL-3
GACAGAGGTGCAGGTA	PL-0
GACAGAGTCACAGTAC	PL-Rel
GACAGAGTCGGTCCGA	PL-1
GACAGAGTCGTTACGA	PL-3
GACCAATAGCAGCCTC	PL-0
GACCAATAGCGCCTTG	PL-vir1
GACCAATAGTTCGATC	PL-0
GACCAATAGTTGTCGT	PL-Pcd
GACCAATCAAACCCAT	PL-2
GACCAATCAAGTACCT	PL-vir1
GACCAATCACATAACC	PL-1
GACCAATCATCACGAT	PL-vir1
GACCAATGTACGAAAT	PL-0
GACCAATGTTCACCTC	PL-Rel
GACCAATGTTTGGCGC	PL-2
GACCAATTCCAGAGGA	PL-2
GACCAATTCCAGTAGT	PL-2
GACCAATTCGAGAGCA	PL-0
GACCAATTCGGCTTGG	PL-0
GACCTGGAGAAGGGTA	PL-1
GACCTGGAGAGTTGGC	PL-1
GACCTGGAGATGTAAC	PL-1
GACCTGGAGCTCCTCT	PL-1
GACCTGGAGGCTCTTA	PL-1
GACCTGGAGTCGAGTG	PL-0
GACCTGGAGTGTACGG	PL-0
GACCTGGCAATTCCTT	PL-Rel
GACCTGGCACATGACT	PL-2
GACCTGGCACATGTGT	PL-2
GACCTGGCAGCCTTTC	PL-2
GACCTGGGTAAATGAC	PL-3
GACCTGGGTCATATCG	PL-2
GACCTGGTCCTCTAGC	PL-Pcd
GACCTGGTCCTTGGTC	PL-Rel
GACCTGGTCGTAGGAG	PL-3
GACGCGTAGTTTGCGT	PL-2
GACGCGTCAACTGGCC	PL-0
GACGCGTCAAGCGCTC	PL-3
GACGCGTCACAGCGTC	PL-3
GACGCGTCACCAGCAC	PL-0
GACGCGTCACTCAGGC	PL-Rel
GACGCGTCATACAGCT	PL-0
GACGCGTGTACCATCA	PL-1
GACGCGTGTCATATCG	PL-0
GACGCGTGTCCTGCTT	PL-0
GACGCGTGTGGCAAAC	PL-0
GACGCGTGTTGAGGTG	PL-0
GACGCGTTCAGCACAT	PL-2
GACGCGTTCCTCAATT	PL-0
GACGCGTTCTCTGCTG	PL-Rel
GACGCGTTCTGAGTGT	PL-2
GACGCGTTCTGCTGTC	PL-3
GACGGCTAGATCCCGC	PL-Rel
GACGGCTAGGAGTTTA	PL-Rel
GACGGCTAGGGTGTTG	PL-2
GACGGCTAGTGGGTTG	PL-1
GACGGCTCAAAGCAAT	PL-0
GACGGCTCACGACGAA	PL-0
GACGGCTCACTGAAGG	PL-Inos
GACGGCTCAGTAACGG	PL-2
GACGGCTGTAGCCTAT	PL-1
GACGGCTGTCTAGTGT	PL-1
GACGGCTGTGGAAAGA	PL-Inos
GACGGCTGTGGCTCCA	PL-0
GACGGCTTCAAACCGT	PL-2
GACGGCTTCCACGTGG	PL-1
GACGTGCAGACCCACC	PL-robo2
GACGTGCAGACGACGT	PL-0
GACGTGCAGACTTGAA	PL-2
GACGTGCAGCTAAACA	PL-0
GACGTGCAGGAGCGAG	PL-0
GACGTGCCATATGCTG	PL-2
GACGTGCCATCGATGT	PL-Pcd
GACGTGCCATGCGCAC	PL-2
GACGTGCCATTAGCCA	PL-vir1
GACGTGCGTACCGTAT	PL-Rel
GACGTGCGTCAAAGAT	PL-1
GACGTGCGTGCAGGTA	PL-1
GACGTGCGTGGTCCGT	PL-Lsp
GACGTGCGTTCGAATC	PL-0
GACGTGCTCACGATGT	PL-2
GACGTGCTCAGCAACT	PL-Pcd
GACGTGCTCATCGATG	PL-robo2
GACGTGCTCATTGCCC	PL-Rel
GACGTTAAGACGACGT	PL-2
GACGTTAAGACTGTAA	PL-1
GACGTTAAGTTAACGA	PL-robo2
GACGTTACAAAGTGCG	PL-Rel
GACGTTACAATCCGAT	PL-1
GACGTTACAGACGCAA	PL-vir1
GACGTTACAGCGTTCG	PL-0
GACGTTACAGTGGAGT	PL-Rel
GACGTTACATCGGACC	PL-Inos
GACGTTAGTAGAAAGG	PL-Lsp
GACGTTAGTCGAAAGC	PL-3
GACGTTATCACCTCGT	PL-Rel
GACGTTATCGTGACAT	PL-2
GACTAACAGAGGTACC	PL-0
GACTAACAGGGTGTTG	PL-Pcd
GACTAACAGTGGTAAT	PL-1
GACTAACAGTGTCCAT	PL-vir1
GACTAACCAATGGAAT	PL-2
GACTAACCACAACGCC	PL-0
GACTAACCACACAGAG	PL-Inos
GACTAACCACGCTTTC	PL-0
GACTAACCACTGTTAG	PL-2
GACTAACCATACGCTA	PL-0
GACTAACGTCGACTAT	PL-3
GACTAACGTCGAGTTT	PL-1
GACTAACTCGAATGCT	PL-1
GACTAACTCGCATGGC	PL-prolif
GACTAACTCGCTGATA	PL-Rel
GACTAACTCTGGTGTA	PL-Pcd
GACTACAAGATGGGTC	PL-0
GACTACAAGCCACGCT	PL-1
GACTACAAGGATGTAT	PL-0
GACTACAAGGCTAGAC	PL-1
GACTACAAGTACATGA	PL-0
GACTACAAGTGTTGAA	PL-Rel
GACTACAAGTTACGGG	PL-robo2
GACTACACAGTAACGG	PL-Rel
GACTACAGTATGAAAC	PL-3
GACTACATCTAACTCT	PL-2
GACTGCGAGGTGATTA	PL-3
GACTGCGAGTCCCACG	PL-0
GACTGCGCAAGACACG	PL-0
GACTGCGCACATCCGG	PL-Rel
GACTGCGCATCATCCC	PL-0
GACTGCGCATCTACGA	PL-2
GACTGCGCATGCCACG	PL-1
GACTGCGGTCAAAGAT	PL-Inos
GACTGCGGTCGATTGT	PL-1
GACTGCGGTCGGGTCT	PL-robo2
GACTGCGGTCTTGCGG	PL-1
GACTGCGGTCTTGTCC	PL-1
GACTGCGGTGTGGCTC	PL-2
GACTGCGGTTCGGCAC	PL-2
GACTGCGTCACGGTTA	PL-robo2
GACTGCGTCAGAGCTT	PL-Lsp
GACTGCGTCCGTACAA	PL-robo2
GAGCAGAAGCCACGCT	PL-3
GAGCAGAAGCTGATAA	PL-0
GAGCAGAAGGAGTAGA	PL-1
GAGCAGAAGGTACTCT	PL-1
GAGCAGAAGTTTAGGA	PL-Pcd
GAGCAGACAATCGGTT	PL-Rel
GAGCAGACACACCGAC	PL-3
GAGCAGAGTTATTCTC	PL-robo2
GAGCAGATCATGCAAC	PL-Pcd
GAGCAGATCTGAGTGT	PL-1
GAGGTGAAGAAGGTGA	PL-1
GAGGTGAAGAATGTTG	PL-Rel
GAGGTGAAGACTGTAA	PL-0
GAGGTGAAGCTAGTCT	PL-Rel
GAGGTGAAGGGTCGAT	PL-2
GAGGTGAAGTAGGTGC	PL-1
GAGGTGACAAGAAGAG	PL-Inos
GAGGTGACAATCGAAA	PL-2
GAGGTGACAATTCCTT	PL-1
GAGGTGACACGACTCG	PL-Rel
GAGGTGACATGGGAAC	PL-0
GAGGTGATCAACCATG	PL-2
GAGGTGATCATGTCTT	PL-0
GAGGTGATCCACGAAT	PL-0
GAGGTGATCCAGATCA	PL-3
GAGGTGATCCCAGGTG	PL-2
GAGGTGATCGGTTAAC	PL-0
GAGGTGATCTTACCTA	PL-0
GAGTCCGAGAGGTTGC	PL-vir1
GAGTCCGAGCACAGGT	PL-Rel
GAGTCCGAGCCGGTAA	PL-1
GAGTCCGAGGACAGCT	PL-3
GAGTCCGAGTAGCCGA	PL-prolif
GAGTCCGCATAAAGGT	PL-2
GAGTCCGCATATGAGA	PL-2
GAGTCCGGTAATTGGA	PL-0
GAGTCCGGTATATCCG	PL-1
GAGTCCGGTATCAGTC	PL-Rel
GAGTCCGGTCTCACCT	PL-3
GAGTCCGGTCTCCACT	PL-Lsp
GAGTCCGTCATGTCTT	PL-Inos
GAGTCCGTCCAAGTAC	PL-0
GAGTCCGTCCCGGATG	PL-2
GAGTCCGTCTATCCCG	PL-2
GAGTCCGTCTGGCGTG	PL-2
GATCAGTAGAAGGGTA	PL-1
GATCAGTAGATGAGAG	PL-2
GATCAGTAGGCTCTTA	PL-2
GATCAGTAGTCAATAG	PL-2
GATCAGTAGTGGGTTG	PL-2
GATCAGTCACGTTGGC	PL-2
GATCAGTCACTGTTAG	PL-2
GATCAGTCAGACGTAG	PL-2
GATCAGTCAGGCAGTA	PL-0
GATCAGTGTACCGAGA	PL-2
GATCAGTGTAGAGGAA	PL-Rel
GATCAGTGTCTAGGTT	PL-Inos
GATCAGTGTGCGATAG	PL-robo2
GATCAGTGTTAGGGTG	PL-2
GATCAGTGTTCCAACA	PL-vir1
GATCAGTTCCATGCTC	PL-0
GATCGATAGGCAGTCA	PL-Pcd
GATCGATCAAGTTCTG	PL-0
GATCGATCACGACGAA	PL-0
GATCGATCAGGCAGTA	PL-Lsp
GATCGATCAGTCACTA	PL-Lsp
GATCGATCATATACGC	PL-Rel
GATCGATGTAGAAAGG	PL-2
GATCGATGTCGCGAAA	PL-0
GATCGCGAGAAGGTTT	PL-robo2
GATCGCGAGACTTTCG	PL-1
GATCGCGAGAGGTTAT	PL-2
GATCGCGAGCGTTCCG	PL-0
GATCGCGCAACTTGAC	PL-2
GATCGCGCAGATGAGC	PL-Inos
GATCGCGCATATACGC	PL-3
GATCGCGCATGCCTTC	PL-Rel
GATCGCGGTAGCACGA	PL-0
GATCGCGGTCTCAACA	PL-Rel
GATCGCGGTGACGCCT	PL-Lsp
GATCGCGGTGGACGAT	PL-ImpL2
GATCGCGGTTACTGAC	PL-0
GATCGCGTCGTTTATC	PL-1
GATCGCGTCTATCGCC	PL-2
GATCGCGTCTCCGGTT	PL-1
GATCGCGTCTTGAGGT	PL-Rel
GATCGTAAGAGACGAA	PL-3
GATCGTAAGCCACGCT	PL-Rel
GATCGTAAGCGCCTCA	PL-Rel
GATCGTAAGGCAAAGA	PL-2
GATCGTAAGTCCAGGA	PL-robo2
GATCGTAAGTTAAGTG	PL-Lsp
GATCGTACACATGTGT	PL-Pcd
GATCGTACAGACAGGT	PL-0
GATCGTACAGGCGATA	PL-Pcd
GATCGTACATAGTAAG	PL-Pcd
GATCGTAGTACAGCAG	PL-2
GATCGTAGTTCACCTC	PL-0
GATCGTAGTTCGTCTC	PL-Rel
GATCGTATCCTGCTTG	PL-3
GATCGTATCGCGCCAA	PL-Lsp
GATCGTATCTTTACAC	PL-vir1
GATCTAGAGACACTAA	PL-2
GATCTAGCACAGAGGT	PL-0
GATCTAGCACTTCTGC	PL-2
GATCTAGCAGCTGGCT	PL-0
GATCTAGCAGGATTGG	PL-0
GATCTAGCAGGGTATG	PL-2
GATCTAGCATCCCATC	PL-Inos
GATCTAGGTAGAGTGC	PL-0
GATCTAGGTCCTAGCG	PL-2
GATCTAGGTCGGGTCT	PL-2
GATCTAGGTTGTTTGG	PL-Rel
GATCTAGTCGCTAGCG	PL-3
GATGAAAAGAGGGATA	PL-Lsp
GATGAAAAGATATGCA	PL-Inos
GATGAAAAGCTGGAAC	PL-3
GATGAAAAGGATGCGT	PL-robo2
GATGAAAAGGCAGTCA	PL-Rel
GATGAAAAGGCCGAAT	PL-Pcd
GATGAAAAGGCTAGCA	PL-Pcd
GATGAAACAAGGACAC	PL-0
GATGAAACAATCTGCA	PL-vir1
GATGAAACATACAGCT	PL-Rel
GATGAAAGTAGCCTCG	PL-0
GATGAAATCACCATAG	PL-2
GATGAAATCAGATAAG	PL-2
GATGAAATCAGCACAT	PL-3
GATGAAATCTGGCGTG	PL-robo2
GATGAGGAGGAGCGAG	PL-1
GATGAGGCACAGACTT	PL-1
GATGAGGCACCAGGCT	PL-2
GATGAGGCACTTCTGC	PL-2
GATGAGGCATGCTGGC	PL-1
GATGAGGGTACTTGAC	PL-robo2
GATGAGGGTCGCGAAA	PL-1
GATGAGGGTGCCTGCA	PL-1
GATGAGGGTGCGAAAC	PL-0
GATGAGGGTGGTACAG	PL-Rel
GATGAGGGTTTACTCT	PL-1
GATGAGGTCAGCCTAA	PL-Inos
GATGAGGTCATCGCTC	PL-1
GATGAGGTCGACAGCC	PL-Rel
GATGCTAAGACTTGAA	PL-robo2
GATGCTACAAGAGTCG	PL-1
GATGCTACAAGCCATT	PL-vir1
GATGCTACACACCGCA	PL-AMP
GATGCTACACAGGAGT	PL-1
GATGCTACACCGAAAG	PL-2
GATGCTACACTTCGAA	PL-0
GATGCTACATGCAATC	PL-robo2
GATGCTAGTTCTGGTA	PL-0
GATGCTATCCCAACGG	PL-0
GATGCTATCTTGCATT	PL-1
GATTCAGAGTATTGGA	PL-Rel
GATTCAGCAACTGCGC	PL-0
GATTCAGCAATGGACG	PL-Lsp
GATTCAGCAATTCCTT	PL-2
GATTCAGCACAACGTT	PL-Pcd
GATTCAGCACAACTGT	PL-2
GATTCAGCACCGTTGG	PL-0
GATTCAGCACTTCTGC	PL-0
GATTCAGCAGAGTGTG	PL-1
GATTCAGGTGCGAAAC	PL-1
GATTCAGGTGTGTGCC	PL-2
GATTCAGTCGTCACGG	PL-2
GCAAACTAGAGACTAT	PL-2
GCAAACTCACCAACCG	PL-Rel
GCAAACTCACCCATGG	PL-2
GCAAACTCAGCGTTCG	PL-3
GCAAACTCAGGACGTA	PL-Pcd
GCAAACTCATGGTCAT	PL-1
GCAAACTGTAGAGTGC	PL-robo2
GCAAACTGTCGAACAG	PL-Pcd
GCAAACTGTCTAACGT	PL-robo2
GCAAACTTCCCAGGTG	PL-3
GCAAACTTCCTTGACC	PL-Rel
GCAAACTTCGAATGGG	PL-2
GCAAACTTCGATAGAA	PL-0
GCAATCAAGAGTTGGC	PL-3
GCAATCAAGGGTCTCC	PL-0
GCAATCACACGAAACG	PL-Pcd
GCAATCACACGAGAGT	PL-0
GCAATCACAGCAGTTT	PL-Lsp
GCAATCACAGCATACT	PL-0
GCAATCACATGTAAGA	PL-1
GCAATCAGTCAGAAGC	PL-3
GCAATCAGTGTTCTTT	PL-2
GCAATCATCACTTATC	PL-2
GCAATCATCCAGAGGA	PL-1
GCAATCATCTGTTTGT	PL-Rel
GCAATCATCTTATCTG	PL-2
GCACATAAGCCGCCTA	PL-Rel
GCACATAAGCTACCGC	PL-1
GCACATAAGGTTCCTA	PL-0
GCACATAAGTGAAGAG	PL-1
GCACATACACAGGAGT	PL-Lsp
GCACATACACCTCGTT	PL-Rel
GCACATACACGAAGCA	PL-0
GCACATACATGACATC	PL-0
GCACATACATTGTGCA	PL-2
GCACATAGTAGCGTAG	PL-0
GCACATAGTCACCTAA	PL-0
GCACATAGTCACTGGC	PL-Rel
GCACATAGTTAAGGGC	PL-0
GCACATAGTTGGTTTG	PL-2
GCACATATCTTAGCCC	PL-Pcd
GCACTCTAGCCACGCT	PL-2
GCACTCTAGGTCATCT	PL-0
GCACTCTCAATGACCT	PL-0
GCACTCTCAATGGTCT	PL-3
GCACTCTCATATGAGA	PL-0
GCACTCTGTACCGTAT	PL-Rel
GCACTCTGTCCATGAT	PL-vir1
GCACTCTGTCTTGATG	PL-AMP
GCACTCTGTTGATTCG	PL-1
GCACTCTTCACGCATA	PL-2
GCACTCTTCCACGCAG	PL-0
GCACTCTTCCTCATTA	PL-2
GCACTCTTCGGACAAG	PL-Lsp
GCACTCTTCGTTGCCT	PL-0
GCACTCTTCTTAGCCC	PL-3
GCAGCCAAGAATGTTG	PL-2
GCAGCCAAGCTCAACT	PL-0
GCAGCCAAGTTATCGC	PL-robo2
GCAGCCACACAGTCGC	PL-Rel
GCAGCCACACGCATCG	PL-2
GCAGCCACATGGTAGG	PL-vir1
GCAGCCAGTAATCACC	PL-robo2
GCAGCCAGTAGGCATG	PL-robo2
GCAGCCAGTGATGATA	PL-robo2
GCAGCCAGTTACGGAG	PL-0
GCAGCCATCGCTTGTC	PL-1
GCAGCCATCTCCCTGA	PL-1
GCAGCCATCTCGTATT	PL-0
GCAGCCATCTCTGAGA	PL-Inos
GCAGTTAAGAGGTACC	PL-1
GCAGTTAAGCTAAGAT	PL-2
GCAGTTAAGTTACCCA	PL-Rel
GCAGTTACAATTGCTG	PL-1
GCAGTTACACTAGTAC	PL-0
GCAGTTACAGCCTTTC	PL-0
GCAGTTACATACTCTT	PL-Rel
GCAGTTAGTAAGTAGT	PL-0
GCAGTTAGTACCAGTT	PL-2
GCAGTTAGTAGCTAAA	PL-1
GCAGTTAGTATAATGG	PL-0
GCAGTTAGTATTCTCT	PL-1
GCAGTTAGTCATATGC	PL-1
GCAGTTAGTCGAATCT	PL-0
GCAGTTAGTGCTCTTC	PL-1
GCAGTTAGTTCGCTAA	PL-Inos
GCAGTTAGTTTGTTGG	PL-Pcd
GCAGTTATCCACGTTC	PL-0
GCAGTTATCCAGAAGG	PL-0
GCAGTTATCCCGGATG	PL-1
GCAGTTATCCGCTGTT	PL-3
GCAGTTATCGGCCGAT	PL-Rel
GCATACAAGCCAGGAT	PL-0
GCATACAAGCTAGTGG	PL-robo2
GCATACAAGTACCGGA	PL-Rel
GCATACAAGTCTCCTC	PL-Inos
GCATACACAATACGCT	PL-3
GCATACACACTTAAGC	PL-0
GCATACACATACCATG	PL-Rel
GCATACACATCGATGT	PL-0
GCATACAGTACAAGTA	PL-Rel
GCATACAGTCAGCTAT	PL-2
GCATACAGTCCGAGTC	PL-1
GCATACAGTGGTCCGT	PL-3
GCATACATCAGCGATT	PL-Pcd
GCATACATCAGTTGAC	PL-2
GCATACATCCCTGACT	PL-Rel
GCATACATCCTGCAGG	PL-0
GCATACATCTAAGCCA	PL-Inos
GCATGATAGTCGCCGT	PL-0
GCATGATAGTGGGTTG	PL-vir1
GCATGATCACATCCAA	PL-1
GCATGATCACCACCAG	PL-Lsp
GCATGATCAGTCAGAG	PL-0
GCATGATCATGGATGG	PL-1
GCATGATGTACCGGCT	PL-1
GCATGATGTAGCGCTC	PL-1
GCATGATGTCAAAGCG	PL-1
GCATGATGTCCGAACC	PL-1
GCATGATGTCGAGTTT	PL-1
GCATGATGTCTTGCGG	PL-2
GCATGATGTGAGTGAC	PL-0
GCATGATGTTATTCTC	PL-0
GCATGATTCAGCTCGG	PL-Pcd
GCATGATTCAGGATCT	PL-1
GCATGATTCGGATGGA	PL-Rel
GCATGATTCTAACCGA	PL-2
GCATGATTCTGTTTGT	PL-3
GCATGATTCTTAGCCC	PL-1
GCATGCGAGAGACTTA	PL-Rel
GCATGCGAGTCGTTTG	PL-1
GCATGCGCAACGATCT	PL-1
GCATGCGCACGGCTAC	PL-0
GCATGCGCATCAGTAC	PL-2
GCATGCGCATTGGTAC	PL-1
GCATGCGGTAAACCTC	PL-0
GCATGCGGTAGCGCAA	PL-ImpL2
GCATGCGGTCATATCG	PL-3
GCATGCGGTGCCTGGT	PL-1
GCATGCGGTGCTTCTC	PL-vir1
GCATGCGGTTGCGTTA	PL-Rel
GCATGCGGTTGGTGGA	PL-0
GCATGCGTCACAGGCC	PL-2
GCATGCGTCCAAATGC	PL-prolif
GCATGCGTCGCATGAT	PL-0
GCATGTAAGAGAACAG	PL-3
GCATGTAAGCAATATG	PL-robo2
GCATGTAAGGATTCGG	PL-3
GCATGTAAGGCCATAG	PL-2
GCATGTACAACGATCT	PL-1
GCATGTACAACGCACC	PL-1
GCATGTACAACTGGCC	CC
GCATGTACACGAAAGC	PL-vir1
GCATGTACAGTTAACC	PL-Pcd
GCATGTAGTACTTAGC	PL-2
GCATGTAGTAGCAAAT	PL-2
GCATGTAGTCAAACTC	PL-3
GCATGTAGTCAGTGGA	PL-1
GCATGTAGTCTAGCCG	PL-Rel
GCATGTAGTGGAAAGA	PL-0
GCATGTAGTTAGTGGG	PL-2
GCATGTAGTTTAAGCC	PL-robo2
GCATGTATCACTCTTA	PL-2
GCATGTATCATCGCTC	PL-2
GCATGTATCGAATGCT	PL-3
GCATGTATCGCAGGCT	PL-Lsp
GCATGTATCGTTACGA	PL-Pcd
GCCAAATAGAAGGCCT	PL-Rel
GCCAAATAGCCTTGAT	PL-0
GCCAAATAGCGGATCA	PL-0
GCCAAATAGCGTAGTG	PL-2
GCCAAATCAGCATGAG	PL-Inos
GCCAAATCATACTACG	PL-3
GCCAAATCATATACGC	PL-Rel
GCCAAATCATCACGTA	PL-robo2
GCCAAATGTAACGTTC	PL-3
GCCAAATGTCTGCCAG	PL-1
GCCAAATGTGTGCGTC	PL-Rel
GCCAAATGTTATCCGA	PL-1
GCCAAATGTTGGTTTG	PL-3
GCCAAATGTTTACTCT	PL-Inos
GCCAAATGTTTGTGTG	PL-robo2
GCCTCTAAGCTCCTTC	PL-Pcd
GCCTCTAAGGGTTCCC	PL-robo2
GCCTCTAAGTACGACG	PL-Rel
GCCTCTAAGTCCGTAT	PL-2
GCCTCTACACCGATAT	PL-3
GCCTCTAGTTCCAACA	PL-Rel
GCCTCTATCATGTGGT	PL-Rel
GCCTCTATCGTATCAG	PL-Rel
GCGACCAAGGACAGAA	PL-1
GCGACCAAGTACGTAA	PL-Pcd
GCGACCACAAAGCAAT	PL-robo2
GCGACCACAGCCTTTC	PL-1
GCGACCACAGGCGATA	PL-2
GCGACCAGTCAAAGCG	PL-Rel
GCGACCATCACCGTAA	PL-3
GCGAGAAAGAACAACT	PL-3
GCGAGAAAGACTAAGT	PL-0
GCGAGAACACGACTCG	PL-1
GCGAGAACATGGTAGG	PL-3
GCGAGAACATTCTTAC	PL-0
GCGAGAAGTAGCTAAA	PL-0
GCGAGAAGTCTCCACT	PL-2
GCGAGAATCAATCTCT	PL-Rel
GCGAGAATCATCGCTC	PL-1
GCGCAACAGCGTTCCG	PL-robo2
GCGCAACAGCTGGAAC	PL-2
GCGCAACAGTAACCCT	PL-2
GCGCAACAGTCACGCC	PL-1
GCGCAACAGTGTCTCA	PL-vir1
GCGCAACCAGATCTGT	PL-2
GCGCAACCAGCTTAAC	PL-1
GCGCAACCAGTATCTG	PL-Rel
GCGCAACCATGCCACG	PL-0
GCGCAACCATTACCTT	PL-0
GCGCAACGTATATGGA	PL-robo2
GCGCAACGTCTGCAAT	PL-0
GCGCAACGTGAGGGAG	PL-Inos
GCGCAACGTGATGTCT	PL-Pcd
GCGCAACGTGCAACTT	PL-3
GCGCAACGTGTGCCTG	PL-Lsp
GCGCAACGTTCCTCCA	PL-2
GCGCAACGTTTGTGTG	PL-Rel
GCGCAACTCCAAATGC	PL-1
GCGCAACTCCGCAGTG	PL-2
GCGCAACTCGCCGTGA	PL-1
GCGCAGTAGAGAGCTC	PL-2
GCGCAGTAGATGTGGC	PL-1
GCGCAGTAGCAGGCTA	PL-0
GCGCAGTAGGCCGAAT	PL-0
GCGCAGTAGTATCTCG	PL-3
GCGCAGTCAAGCCGTC	PL-robo2
GCGCAGTCAAGCGCTC	PL-0
GCGCAGTCACACAGAG	PL-1
GCGCAGTCACGGACAA	PL-Rel
GCGCAGTCATGGTAGG	PL-1
GCGCAGTGTAGCTTGT	PL-1
GCGCAGTGTGTAAGTA	PL-2
GCGCAGTTCCCTTGTG	PL-Rel
GCGCAGTTCCTTTACA	PL-1
GCGCAGTTCGATGAGG	PL-2
GCGCAGTTCTCCAACC	PL-2
GCGCAGTTCTCTGAGA	PL-1
GCGCCAAAGAGCTATA	PL-robo2
GCGCCAAAGCGATGAC	PL-vir1
GCGCCAAAGTAGCGGT	PL-vir1
GCGCCAACACCAGGCT	PL-Pcd
GCGCCAACACGAAATA	PL-2
GCGCCAACACGTCTCT	PL-0
GCGCCAACAGGTGGAT	PL-1
GCGCCAACATCTCCCA	PL-vir1
GCGCCAAGTATCGCAT	PL-vir1
GCGCCAAGTCCGTCAG	PL-Pcd
GCGCCAAGTCGGCATC	PL-0
GCGCCAAGTGAAAGAG	PL-0
GCGCCAAGTGGCCCTA	PL-Inos
GCGCCAATCCTCGCAT	PL-Rel
GCGCCAATCCTTTCGG	PL-1
GCGCCAATCGTTGACA	PL-1
GCGCGATAGACAGACC	PL-1
GCGCGATAGAGATGAG	PL-1
GCGCGATAGGCGATAC	PL-robo2
GCGCGATAGGTTACCT	PL-2
GCGCGATCAAGCTGGA	PL-3
GCGCGATCACTACAGT	PL-Lsp
GCGCGATCACTCAGGC	PL-Lsp
GCGCGATCATCGATGT	PL-1
GCGCGATCATGAAGTA	PL-2
GCGCGATGTAGAAAGG	PL-2
GCGCGATGTGCAGGTA	PL-Pcd
GCGCGATGTGTGGCTC	PL-0
GCGCGATGTTTACTCT	PL-0
GCGCGATTCAATAAGG	PL-Lsp
GCGCGATTCAGCAACT	PL-0
GCGCGATTCATGCAAC	PL-3
GCGGGTTAGACATAAC	PL-Inos
GCGGGTTAGAGTGAGA	PL-Rel
GCGGGTTAGATCCCAT	PL-3
GCGGGTTAGATGTGTA	PL-Rel
GCGGGTTAGTACGATA	PL-Pcd
GCGGGTTCACAGACTT	PL-Rel
GCGGGTTCATGTTGAC	PL-0
GCGGGTTCATTCTCAT	PL-vir1
GCGGGTTGTAGGCTGA	PL-0
GCGGGTTTCAGAGCTT	PL-2
GCGGGTTTCCGCATCT	PL-0
GCGGGTTTCGTGTAGT	PL-2
GCGGGTTTCTGTACGA	PL-0
GCTCCTAAGAAACGCC	PL-0
GCTCCTAAGCCACTAT	PL-Rel
GCTCCTAAGCTAGTGG	PL-1
GCTCCTAAGGCTACGA	PL-2
GCTCCTAAGTGACTCT	PL-0
GCTCCTAAGTTATCGC	PL-robo2
GCTCCTACAAACTGCT	PL-2
GCTCCTACATGAGCGA	PL-vir1
GCTCCTACATGGGACA	PL-3
GCTCCTAGTCAATGTC	PL-robo2
GCTCCTAGTCCAAGTT	PL-0
GCTCCTAGTCTAGAGG	PL-robo2
GCTCCTAGTCTCTCTG	PL-Rel
GCTCCTAGTTCACCTC	PL-vir1
GCTCCTATCAACGAAA	PL-1
GCTCCTATCACATGCA	PL-Inos
GCTCCTATCTAAGCCA	PL-3
GCTCTGTCAATGCCAT	PL-robo2
GCTCTGTCACGGCCAT	PL-Rel
GCTCTGTCACTCGACG	PL-Rel
GCTCTGTCAGATCGGA	PL-robo2
GCTCTGTCAGGAACGT	PL-1
GCTCTGTGTCAGATAA	PL-0
GCTCTGTGTCCCTTGT	PL-1
GCTCTGTGTGGTCCGT	PL-3
GCTCTGTGTTGATTCG	PL-0
GCTCTGTTCCATTCTA	PL-1
GCTCTGTTCTGGTTCC	PL-0
GCTGCAGAGATCCCAT	PL-2
GCTGCAGAGATCGGGT	PL-3
GCTGCAGAGATCTGCT	PL-Pcd
GCTGCAGAGGATGCGT	PL-3
GCTGCAGAGTAGGCCA	PL-2
GCTGCAGAGTTGTAGA	PL-2
GCTGCAGCAACACCCG	PL-1
GCTGCAGCACAAGTAA	PL-vir1
GCTGCAGCACATGGGA	PL-2
GCTGCAGCAGCGATCC	PL-0
GCTGCAGCAGGGTTAG	PL-2
GCTGCAGCATGTCTCC	PL-3
GCTGCAGGTCACCCAG	PL-2
GCTGCAGGTCATATCG	PL-0
GCTGCAGGTCGTTGTA	PL-Rel
GCTGCAGGTGCTTCTC	PL-1
GCTGCAGTCAATCTCT	PL-0
GCTGCAGTCGCAGGCT	PL-3
GCTGCGAAGATCACGG	PL-3
GCTGCGAAGCCAGAAC	PL-Rel
GCTGCGAAGCGTCTAT	PL-Rel
GCTGCGACAAGGGTCA	PL-vir1
GCTGCGACACGGTGTC	PL-Rel
GCTGCGACAGTTCATG	PL-Pcd
GCTGCGAGTATTCTCT	PL-0
GCTGCGAGTCTGATCA	PL-1
GCTGCGAGTGGAAAGA	PL-Rel
GCTGCGATCCACTCCA	PL-robo2
GCTGCGATCCAGGGCT	PL-Pcd
GCTGCGATCTGCTGTC	PL-2
GCTGCGATCTTGAGGT	PL-2
GCTGCTTAGAAACCTA	PL-1
GCTGCTTAGAATTGTG	PL-2
GCTGCTTAGACTAGAT	PL-2
GCTGCTTAGAGATGAG	PL-2
GCTGCTTAGCGTAGTG	PL-0
GCTGCTTAGCTTTGGT	PL-0
GCTGCTTAGGGCTTGA	PL-Pcd
GCTGCTTAGTGCTGCC	PL-Rel
GCTGCTTAGTGGAGAA	PL-Pcd
GCTGCTTAGTTAAGTG	PL-Pcd
GCTGCTTCAAGTCATC	PL-robo2
GCTGCTTCACGTCTCT	PL-robo2
GCTGCTTCAGATCCAT	PL-2
GCTGCTTGTACTTGAC	PL-3
GCTGCTTGTCCATCCT	PL-3
GCTGCTTGTCGACTAT	PL-AMP
GCTGCTTGTTAGAACA	PL-3
GCTGCTTGTTTCCACC	PL-Rel
GCTGCTTTCCACGTTC	PL-3
GCTGCTTTCGAGGTAG	PL-1
GCTGCTTTCGGCGCAT	PL-2
GCTGGGTAGCACGCCT	PL-0
GCTGGGTAGTCAAGCG	CC
GCTGGGTAGTCCGTAT	PL-Lsp
GCTGGGTCAACGATGG	PL-Inos
GCTGGGTCAAGCTGTT	PL-1
GCTGGGTCAAGGACTG	PL-2
GCTGGGTCAGGGCATA	PL-2
GCTGGGTCATGGTCTA	PL-3
GCTGGGTGTATATCCG	PL-robo2
GCTGGGTGTCAAGCGA	PL-0
GCTGGGTGTGATGATA	PL-0
GCTGGGTGTTAAGAAC	PL-Lsp
GCTGGGTGTTACAGAA	PL-1
GCTGGGTGTTACCGAT	PL-2
GCTGGGTGTTGGTTTG	PL-Rel
GCTGGGTTCAATCTCT	PL-robo2
GCTGGGTTCACGCGGT	PL-2
GCTGGGTTCATCGCTC	PL-3
GCTGGGTTCATCTGCC	PL-Rel
GCTGGGTTCTTTACGT	PL-1
GCTTCCAAGCCAGTAG	PL-0
GCTTCCAAGCTAGTTC	PL-0
GCTTCCAAGGCAATTA	PL-Rel
GCTTCCACAAACGCGA	PL-3
GCTTCCACACATGGGA	PL-0
GCTTCCACACCACGTG	PL-2
GCTTCCACACTATCTT	PL-Lsp
GCTTCCAGTATCTGCA	PL-0
GCTTCCAGTTTAAGCC	PL-3
GCTTCCATCCCGACTT	PL-2
GCTTCCATCCTCTAGC	PL-1
GCTTGAAAGAGGGATA	PL-1
GCTTGAAAGATCACGG	PL-2
GCTTGAAAGCGAAGGG	PL-Rel
GCTTGAACAATAGCGG	PL-2
GCTTGAACAATGGTCT	PL-1
GCTTGAACACACGCTG	PL-0
GCTTGAACAGAGTGTG	PL-Rel
GCTTGAACATAGAAAC	PL-robo2
GCTTGAACATCCTTGC	PL-robo2
GCTTGAACATTCCTCG	PL-robo2
GCTTGAAGTACAGCAG	PL-Rel
GCTTGAAGTAGCGTCC	PL-1
GCTTGAAGTATAATGG	PL-1
GCTTGAAGTCAGCTAT	PL-3
GCTTGAAGTCTCTTAT	PL-0
GCTTGAAGTGCATCTA	PL-0
GCTTGAAGTGTGGTTT	PL-Rel
GCTTGAATCCATGCTC	PL-1
GCTTGAATCTGCTGCT	PL-Rel
GCTTGAATCTTCATGT	PL-Rel
GGAAAGCAGAGGTTAT	PL-Lsp
GGAAAGCCAAGGACAC	PL-2
GGAAAGCCACGTTGGC	PL-1
GGAAAGCCATCCGTGG	PL-2
GGAAAGCCATGGTAGG	PL-vir1
GGAAAGCGTAGCTTGT	PL-Inos
GGAAAGCGTTCACCTC	PL-vir1
GGAAAGCTCACCCGAG	PL-Inos
GGAAAGCTCCGTTGCT	PL-2
GGAAAGCTCCTGCAGG	PL-Rel
GGAAAGCTCGCCTGTT	PL-robo2
GGAAAGCTCGCGTTTC	PL-Rel
GGAAAGCTCGTACCGG	PL-Lsp
GGAACTTAGATCCGAG	PL-2
GGAACTTAGTGAATTG	PL-2
GGAACTTAGTGCAAGC	PL-0
GGAACTTCAAAGTCAA	PL-1
GGAACTTCACATAACC	PL-2
GGAACTTCACATTTCT	PL-robo2
GGAACTTCACCGCTAG	PL-3
GGAACTTCATGCTGGC	PL-Rel
GGAACTTCATGGGACA	PL-2
GGAACTTGTCCGACGT	PL-ImpL2
GGAACTTGTCGCTTTC	PL-0
GGAACTTGTCTTCAAG	PL-Rel
GGAACTTGTGACGCCT	PL-Inos
GGAACTTGTTCGCTAA	PL-0
GGAACTTTCAAGATCC	PL-2
GGAACTTTCAAGCCTA	PL-Rel
GGAACTTTCATGCATG	PL-0
GGAACTTTCATTTGGG	PL-0
GGAACTTTCCTGCAGG	PL-robo2
GGAACTTTCTTGCCGT	PL-Inos
GGAATAAAGAAGGTGA	PL-1
GGAATAAAGCGAGAAA	PL-1
GGAATAAAGGCCGAAT	PL-2
GGAATAACAACAACCT	PL-0
GGAATAACAATGTAAG	PL-0
GGAATAACAGGATTGG	PL-1
GGAATAACATAAAGGT	PL-3
GGAATAAGTAAAGTCA	PL-Lsp
GGAATAAGTAAATACG	PL-Inos
GGAATAAGTAGGACAC	PL-1
GGAATAAGTGACAAAT	PL-2
GGAATAATCATCACCC	PL-2
GGAATAATCATGCTCC	PL-3
GGAATAATCGCTGATA	PL-Rel
GGAATAATCTGCGGCA	PL-1
GGAATAATCTGTTTGT	PL-Rel
GGACAAGAGATGCCAG	PL-0
GGACAAGAGCTGATAA	PL-robo2
GGACAAGAGTCCAGGA	PL-0
GGACAAGAGTCCGTAT	PL-1
GGACAAGCAAAGTGCG	PL-Rel
GGACAAGCAAGTAGTA	PL-1
GGACAAGCACCGGAAA	PL-Rel
GGACAAGCAGTCGTGC	PL-1
GGACAAGCAGTGAGTG	PL-Rel
GGACAAGCATAGGATA	PL-1
GGACAAGGTAGCGCTC	PL-3
GGACAAGGTGCCTGTG	PL-1
GGACAAGTCCGCAAGC	PL-2
GGACAAGTCGGTCCGA	PL-0
GGACAAGTCGGTCTAA	PL-1
GGACAAGTCGTCCGTT	PL-0
GGACAGAAGGCACATG	PL-2
GGACAGAAGGGAGTAA	PL-2
GGACAGAAGTCCCACG	PL-3
GGACAGACAGACGCAA	PL-robo2
GGACAGACATAGACTC	PL-2
GGACAGACATATGGTC	PL-1
GGACAGACATCTATGG	PL-0
GGACAGAGTACAGTGG	PL-1
GGACAGAGTCTAGGTT	PL-0
GGACAGAGTGGCCCTA	PL-Rel
GGACAGATCATCGCTC	PL-Pcd
GGACAGATCGCCCTTA	PL-2
GGACAGATCTGGTGTA	PL-0
GGACATTAGAGATGAG	PL-1
GGACATTAGCTAGTTC	PL-2
GGACATTAGCTATGCT	PL-robo2
GGACATTAGTGTACGG	PL-0
GGACATTAGTGTCCAT	CC
GGACATTCACGAAACG	PL-Inos
GGACATTCAGGGCATA	PL-3
GGACATTGTGGCAAAC	PL-2
GGACATTGTGGTTTCA	PL-Rel
GGACATTGTTACCGAT	PL-3
GGACATTGTTGACGTT	PL-Inos
GGACATTGTTGCGCAC	PL-Pcd
GGACATTGTTTGTTGG	PL-2
GGACATTTCAACTCTT	PL-0
GGACATTTCAAGCCTA	PL-1
GGACATTTCACTCTTA	PL-vir1
GGACATTTCATAGCAC	PL-1
GGACATTTCGGTCCGA	PL-Pcd
GGACATTTCTGAAAGA	PL-1
GGACGTCAGAAGGTGA	PL-Rel
GGACGTCAGGGATACC	PL-Rel
GGACGTCAGTTCCACA	PL-0
GGACGTCCAGGAACGT	PL-0
GGACGTCGTAACGCGA	PL-Lsp
GGACGTCGTCAAACTC	PL-3
GGACGTCGTCGCGGTT	PL-2
GGACGTCTCCAAAGTC	PL-0
GGACGTCTCCGAAGAG	PL-0
GGACGTCTCTCTAAGG	PL-robo2
GGAGCAAAGCAGGTCA	PL-vir1
GGAGCAAAGTGTCCCG	PL-1
GGAGCAACAATGGAGC	PL-Rel
GGAGCAACACCTCGTT	PL-Rel
GGAGCAACAGGCTCAC	PL-ImpL2
GGAGCAACATTGAGCT	PL-Lsp
GGAGCAAGTAGGCATG	PL-0
GGAGCAAGTATAGGGC	PL-Inos
GGAGCAAGTCTACCTC	PL-0
GGAGCAAGTCTCGTTC	PL-Rel
GGAGCAAGTGCCTTGG	PL-1
GGAGCAAGTGTGTGCC	PL-1
GGAGCAAGTTCGCGAC	PL-2
GGAGCAATCAGAAATG	PL-2
GGAGCAATCATAGCAC	PL-1
GGAGCAATCCCTCAGT	PL-robo2
GGAGCAATCGAACTGT	PL-3
GGAGCAATCGGATGTT	PL-0
GGAGCAATCTTGTTTG	PL-vir1
GGATGTTAGACGCTTT	PL-1
GGATGTTAGAGCTATA	PL-Rel
GGATGTTAGAGGTTGC	PL-1
GGATGTTAGGTGCACA	PL-Rel
GGATGTTAGTGCTGCC	PL-Inos
GGATGTTCAGCTTAAC	PL-Pcd
GGATGTTGTAAGTAGT	PL-vir1
GGATGTTGTCGAGATG	PL-0
GGATGTTGTCTCCACT	CC
GGATGTTGTGATAAAC	PL-prolif
GGATGTTGTTACGCGC	PL-vir1
GGATGTTTCAAAGACA	PL-0
GGATGTTTCAGTTTGG	PL-1
GGATGTTTCCTAGGGC	PL-0
GGATGTTTCTTGCATT	PL-1
GGATTACAGCGTGAGT	PL-0
GGATTACAGGACTGGT	PL-0
GGATTACAGGCTAGGT	PL-AMP
GGATTACAGTACGACG	PL-3
GGATTACCACCACCAG	PL-2
GGATTACCAGTATAAG	PL-2
GGATTACGTACCGAGA	PL-Rel
GGATTACGTATATGAG	PL-robo2
GGATTACGTCGCATAT	PL-Pcd
GGATTACGTGGCGAAT	PL-1
GGATTACGTGGTAACG	CC
GGATTACTCGGCGCTA	PL-vir1
GGATTACTCTCTAAGG	PL-3
GGCAATTAGACCTTTG	PL-Rel
GGCAATTAGAGAGCTC	PL-0
GGCAATTAGATGTGTA	PL-Rel
GGCAATTAGTAGGTGC	PL-2
GGCAATTCAAGCGTAG	PL-0
GGCAATTCACCAGGTC	PL-robo2
GGCAATTCACGGTGTC	PL-1
GGCAATTCATCAGTAC	PL-1
GGCAATTTCCAAGTAC	PL-0
GGCAATTTCCCAAGTA	PL-1
GGCAATTTCCGTCATC	PL-2
GGCAATTTCGCAAGCC	PL-0
GGCAATTTCTTCGGTC	PL-vir1
GGCCGATAGCCCAACC	PL-2
GGCCGATAGCCGTCGT	PL-0
GGCCGATAGTCATGCT	PL-Rel
GGCCGATAGTCCGGTC	PL-1
GGCCGATAGTCTCCTC	PL-1
GGCCGATCAAGCCTAT	PL-2
GGCCGATCACATCCGG	PL-Lsp
GGCCGATCAGTAACGG	PL-Rel
GGCCGATCAGTATCTG	PL-0
GGCCGATCATCACGTA	PL-2
GGCCGATGTAAGTGTA	PL-2
GGCCGATGTACATCCA	PL-0
GGCCGATGTACCTACA	PL-robo2
GGCCGATGTAGAGCTG	PL-3
GGCCGATGTCTCATCC	PL-2
GGCCGATGTTCAGACT	PL-Rel
GGCCGATGTTCGGCAC	PL-0
GGCCGATTCACAATGC	PL-3
GGCCGATTCACCCTCA	PL-vir1
GGCCGATTCAGCACAT	PL-3
GGCCGATTCCGTAGTA	PL-2
GGCCGATTCGAATGGG	PL-vir1
GGCCGATTCGCAAACT	PL-vir1
GGCCGATTCGGTCCGA	PL-0
GGCCGATTCTGCAAGT	PL-Pcd
GGCGACTAGATACACA	PL-2
GGCGACTAGCAACGGT	PL-Pcd
GGCGACTAGTATGACA	PL-Pcd
GGCGACTCAAGCGCTC	PL-0
GGCGACTCACCGAATT	PL-Rel
GGCGACTCACCGGAAA	PL-0
GGCGACTCACGCTTTC	PL-Rel
GGCGACTCAGCTGTAT	PL-1
GGCGACTCAGTTCCCT	PL-vir1
GGCGACTGTGAGGGAG	PL-Rel
GGCGACTGTTTACTCT	PL-Rel
GGCGACTTCAACACCA	PL-vir1
GGCGTGTAGAAACCGC	PL-2
GGCGTGTAGGTCGGAT	PL-0
GGCGTGTAGTCCATAC	PL-1
GGCGTGTAGTGCCATT	PL-1
GGCGTGTCACCTATCC	PL-Lsp
GGCGTGTCACGGTAAG	PL-1
GGCGTGTCAGCCTGTG	PL-vir1
GGCGTGTCAGGTGCCT	PL-0
GGCGTGTCATGCTAGT	PL-1
GGCGTGTGTATATGAG	PL-Rel
GGCGTGTGTCCGAACC	PL-2
GGCGTGTGTCGATTGT	PL-1
GGCGTGTGTGATGTGG	PL-1
GGCGTGTGTGTCGCTG	PL-2
GGCGTGTGTTATCCGA	PL-1
GGCGTGTGTTTGTTGG	PL-3
GGCGTGTTCATGGTCA	PL-0
GGCGTGTTCCGCAGTG	PL-0
GGCGTGTTCGAGGTAG	PL-Rel
GGCTCGAAGAAGCCCA	PL-2
GGCTCGAAGACTGGGT	PL-Rel
GGCTCGAAGCGATATA	PL-2
GGCTCGAAGCTAACTC	PL-Rel
GGCTCGAAGCTAGCCC	PL-0
GGCTCGAAGGTCATCT	PL-0
GGCTCGAAGTCACGCC	PL-1
GGCTCGACACAAGCCC	PL-Inos
GGCTCGACACGACTCG	PL-1
GGCTCGACAGCTCGCA	PL-robo2
GGCTCGACATATACGC	PL-3
GGCTCGACATGCCACG	PL-Lsp
GGCTCGACATGTCCTC	PL-0
GGCTCGACATTAGGCT	PL-1
GGCTCGAGTACCTACA	PL-2
GGCTCGAGTATTCTCT	PL-Rel
GGCTCGAGTCAAGCGA	PL-Rel
GGCTCGAGTGCCTGCA	PL-vir1
GGCTCGATCGAGGTAG	PL-2
GGCTCGATCGGATGTT	PL-Lsp
GGCTCGATCTGCCAGG	PL-Rel
GGCTGGTAGAAGGTGA	PL-Lsp
GGCTGGTAGTGGAGTC	PL-0
GGCTGGTAGTTAGCGG	PL-1
GGCTGGTCAGCCAATT	PL-0
GGCTGGTCAGCCACCA	PL-1
GGCTGGTCAGCTGTAT	PL-vir1
GGCTGGTCAGGAATCG	PL-1
GGCTGGTGTCGAGTTT	PL-2
GGCTGGTGTCGCATAT	PL-2
GGCTGGTGTCGTCTTC	PL-0
GGCTGGTGTGCACGAA	PL-3
GGCTGGTGTTGGAGGT	PL-Pcd
GGCTGGTTCACATACG	PL-2
GGCTGGTTCATACGGT	PL-0
GGCTGGTTCGCCTGTT	PL-2
GGCTGGTTCTGCGGCA	PL-2
GGCTGGTTCTTAACCT	PL-2
GGGAATGAGCTTTGGT	PL-2
GGGAATGAGGCTCAGA	PL-1
GGGAATGAGGTGTTAA	PL-0
GGGAATGAGTGGCACA	PL-Pcd
GGGAATGAGTTTAGGA	PL-0
GGGAATGCAATGAAAC	PL-Rel
GGGAATGCAGTAAGAT	PL-Pcd
GGGAATGCATGATCCA	PL-Pcd
GGGAATGGTAGGGTAC	PL-2
GGGAATGGTCATATGC	PL-Rel
GGGAATGGTCCTCTTG	PL-0
GGGAATGGTGGCTCCA	PL-Pcd
GGGAATGGTTCCACTC	PL-2
GGGAATGGTTCTCATT	PL-1
GGGAATGTCAAGGCTT	PL-Rel
GGGAATGTCCACTCCA	PL-robo2
GGGAATGTCGACCAGC	PL-Rel
GGGAATGTCTTTACGT	PL-Rel
GGGACCTAGCAATCTC	PL-Pcd
GGGACCTCAAACCTAC	PL-2
GGGACCTCAAGCCATT	PL-1
GGGACCTCAATGGAGC	PL-Rel
GGGACCTCACTCGACG	PL-vir1
GGGACCTCAGTGGGAT	PL-vir1
GGGACCTCAGTTCATG	PL-2
GGGACCTCATGGTCAT	PL-1
GGGACCTGTATTAGCC	PL-0
GGGACCTGTCAACATC	PL-0
GGGACCTTCAAGCCTA	PL-Inos
GGGACCTTCACCGGGT	PL-3
GGGACCTTCGGAAACG	PL-Rel
GGGACCTTCTCTGAGA	PL-vir1
GGGAGATAGCTCCTTC	PL-1
GGGAGATCACATCCAA	PL-3
GGGAGATCAGACAAGC	PL-2
GGGAGATCAGGAATGC	PL-0
GGGAGATCAGTCCTTC	PL-1
GGGAGATCATATACGC	PL-0
GGGAGATCATGAGCGA	PL-2
GGGAGATGTATCACCA	PL-1
GGGAGATGTATGGTTC	PL-0
GGGAGATGTCCAACTA	PL-0
GGGAGATGTCGCCATG	PL-2
GGGAGATGTGTTCGAT	PL-1
GGGAGATGTTCACCTC	PL-1
GGGAGATGTTTGCATG	PL-Inos
GGGAGATTCCTAGGGC	PL-Lsp
GGGAGATTCGTTTATC	PL-2
GGGAGATTCTGTCTCG	PL-vir1
GGGATGAAGAAACCAT	PL-0
GGGATGAAGAGACGAA	PL-0
GGGATGAAGCAGCGTA	PL-Inos
GGGATGAAGCGTTGCC	PL-0
GGGATGAAGTCGTTTG	PL-Rel
GGGATGACAATCTACG	PL-0
GGGATGACATAGGATA	PL-Rel
GGGATGAGTAGCGTCC	PL-Rel
GGGATGAGTGAAGGCT	PL-1
GGGATGAGTGTAATGA	PL-robo2
GGGATGAGTGTTTGGT	PL-3
GGGATGAGTTCCACTC	PL-1
GGGATGATCCACTCCA	PL-vir1
GGGATGATCCGTCATC	PL-0
GGGCACTAGATCACGG	PL-3
GGGCACTAGCAAATCA	PL-0
GGGCACTAGGCAATTA	PL-0
GGGCACTCACCTCGTT	PL-vir1
GGGCACTCAGGATTGG	PL-0
GGGCACTGTCTGCAAT	PL-1
GGGCACTGTGGTGTAG	PL-Lsp
GGGCACTTCAAACGGG	PL-0
GGGCACTTCGACCAGC	CC
GGGCACTTCGTTTATC	PL-2
GGGCACTTCTGCGACG	PL-3
GGGCACTTCTTCGAGA	PL-0
GGGCACTTCTTGGGTA	PL-Rel
GGGCATCAGATGCCTT	PL-vir1
GGGCATCAGCGAGAAA	PL-3
GGGCATCAGTGGAGAA	PL-2
GGGCATCCAGTGGGAT	PL-3
GGGCATCCATAGGATA	PL-3
GGGCATCGTCGAATCT	PL-2
GGGCATCGTGTGAAAT	PL-1
GGGCATCGTTCGCGAC	PL-0
GGGCATCGTTGAGTTC	PL-2
GGGCATCTCGGTTAAC	PL-2
GGGCATCTCTTGAGGT	PL-3
GGGCATCTCTTGCAAG	PL-robo2
GGGTCTGAGGATATAC	PL-2
GGGTCTGCACGGACAA	PL-Rel
GGGTCTGCAGTATGCT	PL-Rel
GGGTCTGGTACCCAAT	PL-vir1
GGGTCTGGTATAATGG	PL-0
GGGTCTGTCAAACAAG	PL-Rel
GGGTCTGTCATGTGGT	PL-2
GGGTCTGTCCAGAAGG	PL-Pcd
GGGTCTGTCCTCTAGC	PL-vir1
GGGTCTGTCCTTAATC	PL-1
GGGTCTGTCGCCGTGA	PL-Rel
GGGTCTGTCTGCCCTA	PL-0
GGGTTGCAGACGCTTT	PL-3
GGGTTGCAGAGACTAT	PL-Rel
GGGTTGCAGATGGGTC	PL-0
GGGTTGCAGGCGCTCT	PL-Inos
GGGTTGCAGGGATCTG	PL-vir1
GGGTTGCAGGTGACCA	PL-1
GGGTTGCAGTACCGGA	PL-1
GGGTTGCCAAAGGCGT	PL-3
GGGTTGCCAAGCGCTC	PL-1
GGGTTGCCAGGACCCT	PL-1
GGGTTGCCATCCCACT	PL-1
GGGTTGCCATCCGTGG	PL-Pcd
GGGTTGCGTGCAGTAG	PL-0
GGGTTGCGTTAGGGTG	PL-Rel
GGGTTGCTCAGTCCCT	PL-0
GGGTTGCTCCAAACTG	PL-1
GGGTTGCTCCACGAAT	PL-3
GGTATTGAGCTCTCGG	PL-Rel
GGTATTGAGGAGCGAG	PL-1
GGTATTGCACACCGCA	PL-1
GGTATTGCACTTAACG	PL-1
GGTATTGCATGACATC	PL-Inos
GGTATTGCATGCGCAC	PL-1
GGTATTGGTCGAGTTT	PL-1
GGTATTGGTCGGCACT	PL-0
GGTATTGGTGCGAAAC	PL-0
GGTATTGGTGTTTGGT	PL-1
GGTATTGGTTAAGACA	PL-2
GGTATTGTCAAAGACA	PL-2
GGTATTGTCAAGGCTT	PL-0
GGTATTGTCACATGCA	PL-Pcd
GGTATTGTCTTGAGGT	PL-Inos
GGTGAAGAGCGCCTCA	PL-vir1
GGTGAAGAGGCGTACA	PL-0
GGTGAAGAGTGAAGAG	PL-1
GGTGAAGAGTGGAGAA	PL-1
GGTGAAGAGTTATCGC	PL-1
GGTGAAGCAACTGCTA	PL-1
GGTGAAGCAAGCGAGT	PL-0
GGTGAAGCAATGCCAT	PL-Pcd
GGTGAAGCAGCCTATA	PL-3
GGTGAAGGTAGAGCTG	PL-2
GGTGAAGGTCGAATCT	PL-robo2
GGTGAAGGTCTAGCGC	PL-vir1
GGTGAAGGTCTTCAAG	PL-Rel
GGTGAAGTCGGAAACG	PL-1
GGTGAAGTCGTTACAG	PL-Rel
GGTGAAGTCTACGAGT	PL-2
GGTGCGTAGTTTGCGT	PL-1
GGTGCGTCAATGACCT	PL-2
GGTGCGTGTATAATGG	PL-2
GGTGCGTGTGCCTGCA	PL-3
GGTGCGTGTTCACCTC	PL-vir1
GGTGCGTGTTGTTTGG	PL-3
GGTGCGTTCACTATTC	PL-0
GGTGCGTTCCCAAGAT	PL-1
GGTGCGTTCCGATATG	PL-Inos
GGTGTTAAGAATAGGG	PL-robo2
GGTGTTAAGGAGTTTA	PL-Rel
GGTGTTACAAGCCATT	PL-0
GGTGTTACAATGAATG	PL-Pcd
GGTGTTACACACAGAG	PL-2
GGTGTTACATGCCTTC	PL-2
GGTGTTAGTATCGCAT	PL-Rel
GGTGTTAGTCACAAGG	PL-3
GGTGTTAGTCGGATCC	PL-0
GGTGTTATCATCTGCC	PL-0
GGTGTTATCCCTTGCA	PL-0
GGTGTTATCGTCCGTT	PL-0
GGTGTTATCTCATTCA	PL-2
GGTGTTATCTCTAGGA	PL-prolif
GTAACGTAGCACGCCT	PL-prolif
GTAACGTAGCCGCCTA	PL-1
GTAACGTAGCTAAACA	PL-0
GTAACGTAGGAGCGTT	PL-2
GTAACGTCAAGTTCTG	PL-robo2
GTAACGTCAATGGTCT	PL-2
GTAACGTCACGGTGTC	PL-vir1
GTAACGTGTATAGGGC	CC
GTAACGTGTATTAGCC	PL-3
GTAACGTTCCAAAGTC	PL-3
GTAACGTTCCGATATG	PL-1
GTAACTGAGAGACTTA	PL-Rel
GTAACTGAGAGCCCAA	PL-2
GTAACTGAGCAGATCG	PL-1
GTAACTGAGCTAAACA	PL-3
GTAACTGAGGTGCAAC	PL-Pcd
GTAACTGCACATTCGA	PL-2
GTAACTGCACCAGATT	PL-2
GTAACTGCATGCCTAA	PL-2
GTAACTGGTAGCCTAT	PL-Rel
GTAACTGGTCCTCTTG	PL-robo2
GTAACTGTCGCCGTGA	PL-0
GTACGTAAGAAACCAT	PL-1
GTACGTAAGACAGAGA	PL-Pcd
GTACGTAAGTGAACAT	PL-Rel
GTACGTAAGTGCCATT	PL-1
GTACGTACAAGACGTG	PL-2
GTACGTACACCCATTC	PL-Rel
GTACGTACAGCGTCCA	PL-Pcd
GTACGTAGTACAAGTA	PL-1
GTACGTAGTCAAAGAT	PL-2
GTACGTAGTTACGACT	PL-1
GTACGTATCAAACGGG	PL-1
GTACGTATCAAAGACA	PL-1
GTACGTATCCGTTGCT	PL-1
GTACGTATCCTCAACC	PL-Pcd
GTACGTATCGAACTGT	PL-3
GTACGTATCGTCTGAA	PL-0
GTACTCCAGAGGTACC	PL-2
GTACTCCCAAACGCGA	PL-3
GTACTCCCACTATCTT	PL-3
GTACTCCCAGTCGATT	PL-Rel
GTACTCCCATGCAATC	PL-Inos
GTACTCCGTCCGTTAA	PL-3
GTACTCCGTTGTACAC	PL-1
GTACTCCTCCTAAGTG	PL-2
GTACTCCTCTAACTGG	PL-Rel
GTACTCCTCTACTCAT	PL-Pcd
GTACTCCTCTCTAGGA	PL-Inos
GTACTCCTCTTACCGC	PL-0
GTACTTTAGAAACGCC	PL-Rel
GTACTTTAGGCACATG	PL-Rel
GTACTTTAGTTCGATC	PL-robo2
GTACTTTCAACACCTA	PL-2
GTACTTTCACGAGAGT	PL-0
GTACTTTCACGGCCAT	PL-robo2
GTACTTTCACTAGTAC	PL-2
GTACTTTCAGACGCAA	PL-0
GTACTTTCATAACCTG	PL-vir1
GTACTTTCATGCAACT	PL-Rel
GTACTTTCATTTCAGG	PL-0
GTACTTTGTACGACCC	PL-2
GTACTTTGTACTTAGC	PL-1
GTACTTTGTCTTCGTC	PL-vir1
GTACTTTTCCAGAAGG	PL-1
GTACTTTTCGGAAACG	PL-2
GTACTTTTCTACGAGT	PL-2
GTAGGCCAGACACGAC	PL-1
GTAGGCCAGCCAGAAC	PL-Inos
GTAGGCCAGTGCAAGC	PL-2
GTAGGCCAGTTATCGC	PL-2
GTAGGCCCAAGGTGTG	PL-2
GTAGGCCCACGGCTAC	PL-3
GTAGGCCCACTGCCAG	PL-2
GTAGGCCCAGCGAACA	PL-vir1
GTAGGCCCAGGAATGC	PL-robo2
GTAGGCCCATACGCTA	PL-Inos
GTAGGCCCATTATCTC	PL-0
GTAGGCCCATTTCACT	PL-1
GTAGGCCGTCAGATAA	PL-1
GTAGGCCGTCGACTGC	PL-2
GTAGGCCGTGCATCTA	PL-0
GTAGGCCGTGGCCCTA	PL-2
GTAGGCCGTTATGCGT	PL-0
GTAGGCCGTTCGCTAA	PL-Rel
GTAGGCCTCGTAGGAG	PL-3
GTAGGCCTCTAACTTC	PL-2
GTAGTCAAGAATGTTG	PL-0
GTAGTCAAGACATAAC	PL-0
GTAGTCAAGACTGTAA	PL-3
GTAGTCAAGAGAACAG	PL-Rel
GTAGTCAAGATTACCC	PL-Rel
GTAGTCAAGCAGGTCA	PL-vir1
GTAGTCAAGGCTAGCA	PL-Rel
GTAGTCACACAGACTT	PL-2
GTAGTCACACAGATTC	PL-Inos
GTAGTCACAGCGTCCA	PL-robo2
GTAGTCAGTCCAGTGC	PL-Rel
GTAGTCAGTCCGAACC	PL-1
GTAGTCAGTCTAGTCA	PL-robo2
GTAGTCAGTGCTAGCC	PL-2
GTAGTCAGTGGTAACG	PL-0
GTAGTCAGTGGTTTCA	PL-3
GTAGTCAGTTCGTCTC	PL-1
GTAGTCAGTTCGTGAT	PL-vir1
GTAGTCATCCAAAGTC	PL-1
GTAGTCATCGGATGTT	PL-Rel
GTATCTTAGAATTGTG	PL-1
GTATCTTAGGGTTTCT	PL-0
GTATCTTAGTCCAGGA	PL-0
GTATCTTCACGAGAGT	PL-0
GTATCTTCATGCATGT	PL-1
GTATCTTCATGGTTGT	PL-Rel
GTATCTTGTTCCACTC	PL-1
GTATCTTGTTTGACAC	PL-1
GTATCTTTCATCGCTC	PL-Pcd
GTATCTTTCTTGCCGT	PL-Rel
GTATTCTAGAATGTGT	PL-Inos
GTATTCTAGATGTAAC	PL-1
GTATTCTAGCACACAG	CC
GTATTCTAGCTTCGCG	PL-2
GTATTCTCACCTGGTG	PL-1
GTATTCTCACTCGACG	PL-Rel
GTATTCTGTAAGTTCC	PL-Rel
GTATTCTGTGGTACAG	PL-Rel
GTATTCTGTGTTGGGA	PL-robo2
GTATTCTGTTAAAGAC	PL-Rel
GTATTCTTCAACGCTA	PL-2
GTATTCTTCATCGATG	PL-1
GTATTCTTCCTCAATT	PL-robo2
GTATTCTTCGTGGGAA	PL-Rel
GTATTCTTCTTGAGAC	PL-1
GTCAAGTAGCCACGCT	PL-0
GTCAAGTAGCTAACTC	PL-Rel
GTCAAGTAGCTGAACG	PL-2
GTCAAGTAGGGTCGAT	PL-1
GTCAAGTAGTTCGATC	PL-Inos
GTCAAGTCACACGCTG	PL-2
GTCAAGTGTAAGTTCC	PL-2
GTCAAGTGTACTTAGC	PL-2
GTCAAGTGTAGCTTGT	PL-Rel
GTCAAGTGTCCGAACC	PL-1
GTCAAGTGTGTGACGA	PL-0
GTCAAGTTCCCACTTG	PL-3
GTCAAGTTCGCAGGCT	PL-2
GTCAAGTTCTGAGTGT	PL-2
GTCACAAAGGGAGTAA	PL-Rel
GTCACAAAGTACTTGC	PL-vir1
GTCACAAAGTGAAGAG	PL-robo2
GTCACAAAGTTAAGTG	PL-0
GTCACAACACACCGCA	PL-robo2
GTCACAACAGACAAGC	PL-1
GTCACAACAGCCACCA	PL-Rel
GTCACAACAGCTCGCA	PL-robo2
GTCACAAGTAGATTAG	PL-0
GTCACAAGTATGAATG	PL-0
GTCACAAGTCATGCAT	PL-1
GTCACAAGTCGAGATG	PL-Rel
GTCACAAGTGGTCCGT	PL-2
GTCACAAGTTTGTTTC	PL-1
GTCACAATCCGAAGAG	PL-robo2
GTCACAATCGAATGCT	PL-vir1
GTCACAATCTGCCAGG	PL-Rel
GTCACGGAGACATAAC	PL-1
GTCACGGAGCGTAATA	PL-3
GTCACGGAGCTAGTCT	PL-3
GTCACGGAGGACGAAA	PL-2
GTCACGGAGGCAAAGA	PL-2
GTCACGGAGGCATGGT	PL-1
GTCACGGAGTAGATGT	PL-Rel
GTCACGGCACAGGCCT	PL-0
GTCACGGCACATGACT	PL-0
GTCACGGCACCGGAAA	PL-2
GTCACGGCAGTAAGCG	PL-0
GTCACGGCAGTACACT	PL-Inos
GTCACGGGTACACCGC	PL-vir1
GTCACGGGTATTCGTG	PL-0
GTCACGGGTCTCACCT	PL-2
GTCACGGGTCTCGTTC	PL-2
GTCACGGTCTTCCTTC	PL-1
GTCATTTAGGAATGGA	PL-0
GTCATTTCACGTCAGC	PL-Rel
GTCATTTCACTGCCAG	PL-vir1
GTCATTTCAGCATACT	PL-0
GTCATTTCAGGCGATA	PL-AMP
GTCATTTGTAAACCTC	PL-2
GTCATTTGTAGAAAGG	PL-2
GTCATTTGTCATACTG	PL-1
GTCATTTGTGGAAAGA	CC
GTCATTTGTTACGACT	PL-1
GTCATTTGTTACGGAG	PL-1
GTCATTTTCAAACAAG	PL-0
GTCATTTTCCCTCTTT	PL-1
GTCATTTTCGCCATAA	PL-2
GTCATTTTCTCAACTT	PL-3
GTCCTCAAGATCACGG	PL-2
GTCCTCAAGATGCCTT	PL-3
GTCCTCAAGCTAGTTC	PL-1
GTCCTCAAGGACAGCT	PL-3
GTCCTCAAGGACGAAA	PL-robo2
GTCCTCAAGTAGATGT	PL-Rel
GTCCTCACAGGTGGAT	PL-3
GTCCTCACATGAAGTA	PL-0
GTCCTCAGTATAGGTA	PL-1
GTCCTCAGTATCGCAT	PL-3
GTCCTCAGTGATAAGT	PL-vir1
GTCCTCATCCTCTAGC	PL-1
GTCCTCATCGCCAAAT	PL-robo2
GTCCTCATCGGAAACG	PL-0
GTCCTCATCTCCAGGG	PL-0
GTCGGGTAGATCCGAG	PL-0
GTCGGGTAGTACCGGA	PL-Pcd
GTCGGGTCAATGTAAG	PL-3
GTCGGGTCACCTGGTG	PL-2
GTCGGGTCAGATGAGC	PL-0
GTCGGGTCATCACAAC	PL-0
GTCGGGTGTAAGTGTA	PL-2
GTCGGGTGTCATCGGC	PL-Lsp
GTCGGGTGTCGATTGT	PL-0
GTCGGGTGTGCTGTAT	PL-2
GTCGGGTGTTCAGTAC	PL-2
GTCGGGTTCAATCACG	PL-3
GTCGGGTTCCAAATGC	PL-Rel
GTCGGGTTCGGCGCAT	PL-1
GTCGGGTTCTGATACG	PL-Rel
GTCGGGTTCTTTACAC	PL-0
GTCGTAAAGAAACCAT	PL-0
GTCGTAAAGCTCCTCT	PL-3
GTCGTAACATCATCCC	PL-2
GTCGTAACATCCTAGA	PL-3
GTCGTAACATTGGGCC	PL-2
GTCGTAAGTATTACCG	PL-0
GTCGTAAGTCTCCCTA	PL-0
GTCGTAATCATCATTC	PL-0
GTCGTAATCCAAACTG	PL-1
GTCGTAATCCACGAAT	PL-0
GTCGTAATCCGAAGAG	PL-0
GTCGTAATCCTGTACC	PL-Pcd
GTCGTAATCGCCCTTA	PL-Rel
GTCGTAATCGGATGGA	PL-2
GTCGTAATCGTAGGTT	PL-AMP
GTCGTAATCTCCAACC	PL-1
GTCGTAATCTTGTTTG	PL-0
GTCTCGTAGACTAAGT	PL-robo2
GTCTCGTAGAGAACAG	PL-Pcd
GTCTCGTAGCACGCCT	PL-0
GTCTCGTAGCCGCCTA	PL-Rel
GTCTCGTAGGTAGCTG	PL-2
GTCTCGTAGTGTCCAT	PL-3
GTCTCGTAGTTGAGTA	PL-Rel
GTCTCGTCAAACTGCT	PL-Lsp
GTCTCGTCAAATACAG	CC
GTCTCGTCAAGGACAC	PL-0
GTCTCGTCAATGAAAC	PL-3
GTCTCGTCAGATGGCA	PL-Rel
GTCTCGTGTATTAGCC	PL-robo2
GTCTCGTGTTCAGCGC	CC
GTCTCGTTCCTAGGGC	PL-Rel
GTCTCGTTCGCAAACT	PL-1
GTCTCGTTCGTTTAGG	PL-2
GTCTCGTTCTTCGGTC	PL-0
GTCTTCGAGATATGGT	PL-1
GTCTTCGAGATGTCGG	PL-Pcd
GTCTTCGAGGACAGCT	PL-robo2
GTCTTCGCACTTCTGC	PL-Lsp
GTCTTCGCAGCTGCAC	PL-1
GTCTTCGCAGTAAGAT	PL-2
GTCTTCGCATCACCCT	PL-1
GTCTTCGCATCAGTCA	PL-0
GTCTTCGGTAAGTGGC	PL-0
GTCTTCGGTAGCGATG	PL-2
GTCTTCGGTCGCCATG	PL-2
GTCTTCGGTTAAGACA	PL-Rel
GTCTTCGGTTAGAACA	PL-3
GTCTTCGGTTGGTAAA	PL-2
GTCTTCGTCAATACCG	PL-robo2
GTCTTCGTCCGTCATC	PL-Rel
GTCTTCGTCGTTTATC	PL-0
GTCTTCGTCTATGTGG	PL-Rel
GTGAAGGAGCCCAACC	PL-0
GTGAAGGAGGTGCACA	PL-0
GTGAAGGAGTGTCCAT	PL-2
GTGAAGGAGTTCCACA	PL-2
GTGAAGGCACGACTCG	PL-3
GTGAAGGCAGGTCCAC	PL-1
GTGAAGGGTCACCCAG	PL-3
GTGAAGGGTCGAATCT	PL-Pcd
GTGAAGGGTCGACTAT	PL-2
GTGAAGGGTCGCATCG	PL-3
GTGAAGGGTCTGATTG	PL-1
GTGAAGGGTGGTTTCA	PL-robo2
GTGAAGGTCGAATGCT	PL-Rel
GTGAAGGTCTGGTTCC	PL-3
GTGCAGCAGATACACA	PL-0
GTGCAGCAGTGGAGAA	PL-1
GTGCAGCAGTTCGATC	PL-0
GTGCAGCCACATCTTT	PL-2
GTGCAGCCACCAGGCT	CC
GTGCAGCCACTTAAGC	PL-1
GTGCAGCCAGCTGCTG	PL-Rel
GTGCAGCCAGGCGATA	PL-Rel
GTGCAGCGTAGGACAC	PL-vir1
GTGCAGCGTCTGCCAG	PL-1
GTGCAGCGTGATGATA	PL-1
GTGCAGCTCACCCTCA	PL-vir1
GTGCAGCTCATGGTCA	PL-Lsp
GTGCAGCTCCTATTCA	PL-Rel
GTGCAGCTCGTTACGA	PL-0
GTGCATAAGACGCAAC	PL-0
GTGCATAAGCCTCGTG	PL-0
GTGCATAAGGAGTAGA	PL-3
GTGCATAGTAGCACGA	PL-2
GTGCATAGTCATCGGC	PL-Rel
GTGCATAGTTAGATGA	PL-Lsp
GTGCATATCGAGGTAG	PL-2
GTGCATATCGCCTGTT	PL-Rel
GTGCATATCGTCTGAA	PL-1
GTGCGGTAGACTAGAT	PL-2
GTGCGGTAGATGGCGT	PL-1
GTGCGGTAGCCGCCTA	PL-2
GTGCGGTAGCTAGGCA	PL-Inos
GTGCGGTAGTAAGTAC	PL-Inos
GTGCGGTCAAGGTGTG	PL-Pcd
GTGCGGTCACCTGGTG	PL-2
GTGCGGTCATACGCTA	PL-3
GTGCGGTGTAGCTTGT	PL-robo2
GTGCGGTGTCGGGTCT	PL-3
GTGCGGTGTTAAGAAC	CC
GTGCGGTTCGTCACGG	PL-1
GTGCGGTTCTAGAGTC	PL-Rel
GTGCGGTTCTGCGACG	PL-2
GTGCTTCAGACTTGAA	PL-2
GTGCTTCAGATCCCGC	PL-vir1
GTGCTTCAGATCGATA	PL-robo2
GTGCTTCAGCAGATCG	PL-AMP
GTGCTTCAGGCCCGTT	PL-3
GTGCTTCAGGGCACTA	PL-2
GTGCTTCAGTCGTTTG	PL-2
GTGCTTCAGTGCAAGC	PL-0
GTGCTTCCAATCGGTT	PL-0
GTGCTTCCAATGGAAT	PL-Lsp
GTGCTTCCATAGAAAC	PL-2
GTGCTTCGTAAACCTC	PL-3
GTGCTTCGTAAATGAC	PL-Rel
GTGCTTCGTAAATGTG	PL-1
GTGCTTCGTCTTGCGG	PL-3
GTGCTTCGTGGTTTCA	PL-3
GTGCTTCGTTGAGGTG	PL-1
GTGCTTCTCCAGAAGG	PL-1
GTGCTTCTCCCTGACT	PL-Inos
GTGCTTCTCCCTTGTG	PL-Rel
GTGCTTCTCCTACAGA	PL-1
GTGGGTCAGATCACGG	PL-Lsp
GTGGGTCAGGCTCAGA	PL-1
GTGGGTCAGTCCGGTC	PL-Rel
GTGGGTCAGTGACTCT	PL-robo2
GTGGGTCAGTTAAGTG	PL-vir1
GTGGGTCAGTTGTAGA	PL-3
GTGGGTCCACATGGGA	PL-Inos
GTGGGTCCACCGATAT	PL-1
GTGGGTCCACCTGGTG	PL-0
GTGGGTCCAGCTCGAC	PL-Rel
GTGGGTCGTCCCGACA	PL-Lsp
GTGGGTCGTTCAGGCC	PL-0
GTGGGTCTCACTTACT	PL-vir1
GTGGGTCTCCGTAGGC	PL-2
GTGGGTCTCGTACGGC	PL-2
GTGGGTCTCTGGCGTG	PL-robo2
GTGTGCGAGAAGATTC	PL-vir1
GTGTGCGAGAGACTTA	PL-3
GTGTGCGAGATCCGAG	PL-Rel
GTGTGCGAGTTATCGC	PL-2
GTGTGCGCAAGAGTCG	PL-2
GTGTGCGCAATGAATG	PL-vir1
GTGTGCGCACGACGAA	PL-Rel
GTGTGCGGTAGCGTGA	PL-2
GTGTGCGGTCTGCAAT	PL-0
GTGTGCGGTTCGTTGA	PL-Lsp
GTGTGCGGTTTGGCGC	PL-0
GTGTGCGTCCACGTGG	PL-2
GTGTGCGTCCTTGACC	PL-0
GTGTTAGAGACCTTTG	PL-Rel
GTGTTAGAGTACTTGC	PL-Rel
GTGTTAGAGTGCTGCC	PL-Rel
GTGTTAGAGTTCGCAT	PL-robo2
GTGTTAGCAGCTGGCT	PL-Lsp
GTGTTAGGTAAGAGAG	PL-vir1
GTGTTAGGTCACTGGC	PL-1
GTGTTAGGTCGCGTGT	PL-3
GTGTTAGGTGTGACCC	PL-0
GTGTTAGTCAACGGGA	PL-0
GTGTTAGTCCTTTCGG	PL-3
GTGTTAGTCGAGAGCA	PL-Pcd
GTGTTAGTCGCCTGAG	PL-2
GTGTTAGTCGTTACAG	PL-Pcd
GTGTTAGTCTAACTCT	PL-2
GTGTTAGTCTGCTGCT	PL-2
GTGTTAGTCTTTCCTC	PL-2
GTTAAGCAGAACAATC	PL-robo2
GTTAAGCAGCCCTAAT	PL-1
GTTAAGCAGGTAGCCA	PL-0
GTTAAGCAGGTGATAT	PL-3
GTTAAGCCAAGTAGTA	PL-Inos
GTTAAGCCACCACGTG	PL-2
GTTAAGCCAGGTCTCG	PL-2
GTTAAGCGTCACACGC	PL-vir1
GTTAAGCTCAAGATCC	PL-3
GTTAAGCTCAGCTTAG	PL-0
GTTACAGAGAGCTATA	PL-3
GTTACAGAGAGTACAT	PL-0
GTTACAGAGGAATTAC	PL-1
GTTACAGAGGTGGGTT	PL-3
GTTACAGAGTGACTCT	PL-2
GTTACAGCAATCACAC	PL-2
GTTACAGCACAGACTT	PL-robo2
GTTACAGCATAAAGGT	PL-3
GTTACAGCATACCATG	PL-Pcd
GTTACAGCATCCTAGA	PL-Rel
GTTACAGCATGACGGA	PL-0
GTTACAGGTACCGCTG	PL-2
GTTACAGGTAGTACCT	PL-0
GTTACAGGTTCGCGAC	PL-2
GTTACAGGTTCGTCTC	PL-3
GTTACAGTCACATACG	PL-Rel
GTTACAGTCCCAGGTG	PL-1
GTTACAGTCTGCGACG	PL-0
GTTCATTAGAAACCTA	PL-2
GTTCATTAGCACACAG	PL-2
GTTCATTAGGCTCATT	PL-2
GTTCATTAGTGGGTTG	PL-3
GTTCATTCAATGGATA	PL-1
GTTCATTCACCAGATT	PL-prolif
GTTCATTCACCGATAT	PL-Rel
GTTCATTCACGAAGCA	PL-Rel
GTTCATTCACTGTGTA	PL-2
GTTCATTGTAAATACG	PL-Rel
GTTCATTGTCATGCAT	PL-0
GTTCATTGTCTAGTCA	PL-Rel
GTTCATTGTGGGTATG	PL-2
GTTCATTGTGTGGCTC	PL-Rel
GTTCATTGTGTTGGGA	PL-Rel
GTTCATTGTTTAGGAA	PL-Rel
GTTCATTGTTTGTGTG	PL-Rel
GTTCATTTCAGCTGGC	PL-robo2
GTTCATTTCATGCATG	LM-2
GTTCATTTCGCAAACT	PL-Inos
GTTCATTTCGCTAGCG	PL-robo2
GTTCATTTCGTTACGA	PL-Rel
GTTCATTTCTACTATC	PL-3
GTTCGGGAGATATGGT	PL-Rel
GTTCGGGAGTACGTTC	PL-0
GTTCGGGAGTAGCCGA	PL-1
GTTCGGGAGTGTTGAA	PL-1
GTTCGGGCACGACGAA	PL-3
GTTCGGGCATCTGGTA	PL-3
GTTCGGGCATTTCACT	PL-1
GTTCGGGGTAAATGTG	PL-1
GTTCGGGGTCGAACAG	PL-robo2
GTTCGGGGTGTTGGGA	PL-0
GTTCGGGGTTCGGGCT	PL-robo2
GTTCGGGGTTCGTGAT	PL-2
GTTCGGGTCCGTACAA	PL-3
GTTCGGGTCGCCTGAG	PL-robo2
GTTCGGGTCGGCGGTT	PL-1
GTTCTCGAGCAATATG	PL-0
GTTCTCGCAATTCCTT	PL-1
GTTCTCGCAGCCAATT	PL-Rel
GTTCTCGCAGTTAACC	PL-Rel
GTTCTCGCATCGGGTC	PL-0
GTTCTCGGTAGCGTGA	PL-0
GTTCTCGGTTGTACAC	PL-Rel
GTTCTCGTCATTATCC	PL-2
GTTCTCGTCCACGTGG	PL-0
GTTCTCGTCCACGTTC	PL-Inos
GTTCTCGTCCTGCCAT	PL-Rel
GTTCTCGTCGCATGAT	PL-2
GTTTCTAAGACTGTAA	PL-1
GTTTCTAAGAGCTTCT	PL-0
GTTTCTAAGATGCCTT	PL-1
GTTTCTAAGGACACCA	PL-Lsp
GTTTCTACACAGACAG	PL-robo2
GTTTCTACAGATGGGT	PL-1
GTTTCTACATACTCTT	PL-Rel
GTTTCTAGTAGGACAC	PL-3
GTTTCTAGTCTCTCGT	PL-2
GTTTCTAGTCTGATCA	PL-Inos
GTTTCTAGTGCACCAC	PL-Rel
GTTTCTATCACATGCA	PL-robo2
GTTTCTATCGAACTGT	PL-1
GTTTCTATCTTCTGGC	PL-2
TAAACCGAGGAGTTTA	PL-Pcd
TAAACCGAGGGTCTCC	PL-robo2
TAAACCGAGTTATCGC	PL-AMP
TAAACCGCAAGCGATG	PL-0
TAAACCGCAAGTACCT	PL-1
TAAACCGCAGATCTGT	PL-robo2
TAAACCGCAGATGAGC	PL-Pcd
TAAACCGCAGTCAGAG	PL-robo2
TAAACCGGTCTAGGTT	PL-0
TAAACCGGTTCCCTTG	PL-Pcd
TAAACCGTCAAAGACA	PL-Rel
TAAACCGTCCGCATAA	PL-1
TAAACCGTCGATGAGG	PL-1
TAAACCGTCGTGGGAA	PL-Rel
TAAACCGTCTGAGTGT	PL-3
TAAGAGAAGACGCACA	PL-1
TAAGAGAAGCTACCTA	PL-1
TAAGAGAAGTAACCCT	PL-0
TAAGAGACAACCGCCA	PL-1
TAAGAGACAACTTGAC	PL-1
TAAGAGACAATCCGAT	PL-prolif
TAAGAGACACGCATCG	PL-2
TAAGAGACAGCCTATA	PL-0
TAAGAGACAGGTCCAC	PL-3
TAAGAGACATAGTAAG	PL-3
TAAGAGACATGTTGAC	PL-0
TAAGAGAGTATGAAAC	PL-1
TAAGAGAGTTCACCTC	PL-0
TAAGAGAGTTCTCATT	PL-2
TAAGAGATCGGAAACG	PL-3
TAAGAGATCTGATTCT	PL-Pcd
TAAGAGATCTTGTTTG	PL-Lsp
TAAGCGTAGAAGGCCT	PL-1
TAAGCGTAGACAGGCT	PL-0
TAAGCGTAGACTAGAT	PL-Inos
TAAGCGTAGATCCTGT	PL-vir1
TAAGCGTAGCCAGAAC	PL-0
TAAGCGTAGGCTCAGA	PL-0
TAAGCGTAGGTAGCCA	PL-2
TAAGCGTAGGTGATTA	PL-1
TAAGCGTAGTGTCCCG	PL-vir1
TAAGCGTCACATGACT	PL-3
TAAGCGTCAGACAAAT	PL-1
TAAGCGTCAGGGTACA	PL-1
TAAGCGTCATCGATGT	PL-2
TAAGCGTCATGAACCT	PL-0
TAAGCGTGTCAGTGGA	PL-2
TAAGCGTGTCCTCCAT	PL-3
TAAGCGTGTCGAGTTT	PL-Rel
TAAGCGTGTTCACCTC	PL-0
TAAGCGTGTTCTCATT	PL-3
TAAGCGTTCAACACGT	PL-0
TAAGCGTTCACAACGT	PL-3
TAAGCGTTCCATGCTC	PL-robo2
TAAGCGTTCCCGACTT	PL-0
TAAGCGTTCCGCTGTT	PL-0
TAAGCGTTCTCACATT	PL-0
TAAGCGTTCTCATTCA	PL-Pcd
TAAGTGCAGACACTAA	PL-3
TAAGTGCAGACTAGGC	PL-1
TAAGTGCAGCTCAACT	PL-1
TAAGTGCAGTGGTAGC	PL-2
TAAGTGCCACTGAAGG	PL-Lsp
TAAGTGCCAGTGAGTG	PL-1
TAAGTGCCATCACGAT	PL-robo2
TAAGTGCGTATTCGTG	PL-1
TAAGTGCGTGGCGAAT	PL-3
TAAGTGCGTTAAGACA	PL-1
TAAGTGCGTTACGGAG	PL-0
TAAGTGCTCCCAGGTG	PL-Rel
TAAGTGCTCCGGCACA	PL-0
TAAGTGCTCGCAAACT	PL-1
TAAGTGCTCGCTGATA	PL-2
TAAGTGCTCTTCGGTC	PL-vir1
TACACGAAGCAGACTG	PL-3
TACACGAAGGCTAGGT	PL-Rel
TACACGAAGTAGCGGT	PL-Rel
TACACGAGTATTACCG	PL-0
TACACGAGTCGCTTTC	PL-3
TACACGAGTCTGCAAT	PL-2
TACACGAGTGAGGCTA	PL-Rel
TACACGAGTGTCTGAT	PL-0
TACACGATCCGTAGGC	PL-2
TACACGATCCTTTACA	PL-Rel
TACACGATCTATCCCG	PL-1
TACACGATCTCCAGGG	PL-Rel
TACAGTGAGGCCCGTT	PL-robo2
TACAGTGAGTGAAGTT	PL-2
TACAGTGCAAAGAATC	PL-0
TACAGTGCAACTGCGC	PL-3
TACAGTGCAAGGACAC	PL-0
TACAGTGCAAGTACCT	PL-0
TACAGTGCAATGAATG	PL-0
TACAGTGCACACCGCA	PL-0
TACAGTGCAGTATCTG	PL-Lsp
TACAGTGGTCGGCACT	PL-0
TACAGTGGTCTAACGT	PL-1
TACAGTGGTGGGTATG	PL-3
TACAGTGTCAACCATG	PL-vir1
TACAGTGTCACTATTC	PL-1
TACAGTGTCATTATCC	PL-2
TACAGTGTCCACGAAT	PL-2
TACAGTGTCCCGGATG	PL-Rel
TACAGTGTCCGCAAGC	PL-0
TACAGTGTCGACAGCC	PL-Pcd
TACAGTGTCTACGAGT	PL-1
TACCTATAGCGTCAAG	PL-0
TACCTATAGCGTCTAT	PL-1
TACCTATAGCTCAACT	PL-Rel
TACCTATAGGAGCGAG	PL-1
TACCTATAGTAGCCGA	PL-0
TACCTATAGTTTAGGA	PL-3
TACCTATCAAGTAGTA	PL-1
TACCTATGTTCAACCA	PL-1
TACCTATGTTGTCGCG	PL-Rel
TACCTATTCAGGTTCA	PL-robo2
TACCTATTCCAAATGC	PL-Rel
TACCTTAAGACTGTAA	PL-3
TACCTTAAGTGAACAT	PL-3
TACCTTACACCTCGTT	PL-vir1
TACCTTACAGCTGCTG	PL-robo2
TACCTTACAGTAAGAT	PL-3
TACCTTACATCCTTGC	PL-2
TACCTTAGTACTTCTT	PL-2
TACCTTAGTAGATTAG	PL-1
TACCTTAGTAGCTGCC	PL-0
TACCTTATCCACGCAG	PL-Inos
TACCTTATCGTAGATC	PL-1
TACCTTATCTACTCAT	PL-0
TACCTTATCTTTACAC	PL-0
TACGGATAGATATGCA	PL-2
TACGGATAGCCCGAAA	PL-0
TACGGATAGCGTGAGT	PL-2
TACGGATAGGAATGGA	PL-2
TACGGATCAAGTTCTG	PL-2
TACGGATCAATAGCGG	PL-1
TACGGATCACACCGCA	PL-0
TACGGATCACCTCGTT	PL-1
TACGGATGTAGCGTCC	PL-2
TACGGATGTATCAGTC	PL-2
TACGGATGTGATAAAC	PL-1
TACGGATGTGATGATA	PL-Inos
TACGGATGTTATGTGC	PL-robo2
TACGGATGTTGGTGGA	PL-robo2
TACGGATTCAAACCAC	PL-Rel
TACGGATTCAGCTCGG	PL-robo2
TACGGATTCCAACCAA	PL-0
TACGGATTCGCGATCG	PL-vir1
TACGGATTCGGCCGAT	PL-Rel
TACGGATTCGTTTGCC	PL-0
TACGGATTCTTGAGAC	PL-0
TACGGATTCTTTACGT	PL-0
TACGGGCAGAGTCGGT	PL-Lsp
TACGGGCAGCCCAGCT	PL-prolif
TACGGGCAGTTGCAGG	PL-Pcd
TACGGGCCAAGCCCAC	PL-1
TACGGGCCAGCTGCAC	PL-robo2
TACGGGCCATCCCACT	PL-Lsp
TACGGGCCATGCTAGT	PL-Inos
TACGGGCCATGGTCAT	PL-Rel
TACGGGCGTTAGAACA	PL-vir1
TACGGGCTCAAGATCC	PL-vir1
TACGGTAAGAAGCCCA	PL-vir1
TACGGTAAGACTCGGA	PL-0
TACGGTAAGCCTCGTG	PL-2
TACGGTAAGCTACCGC	PL-1
TACGGTAAGGTGCACA	PL-2
TACGGTACAATGAAAC	PL-0
TACGGTACACGACGAA	PL-Rel
TACGGTACAGGGAGAG	PL-0
TACGGTACATTAACCG	PL-Rel
TACGGTAGTGGTTTCA	PL-1
TACGGTAGTTTGGCGC	PL-Rel
TACGGTAGTTTGGGCC	PL-Rel
TACGGTATCATATCGG	PL-1
TACGGTATCTCCCTGA	PL-3
TACGGTATCTGTCCGT	PL-Rel
TACTCATAGGACACCA	PL-0
TACTCATAGTAGCGGT	PL-robo2
TACTCATCAAGCCGTC	PL-Pcd
TACTCATCAAGTCATC	PL-Lsp
TACTCATCACCATCCT	PL-robo2
TACTCATCACTAAGTC	PL-0
TACTCATCAGTAGAGC	PL-Rel
TACTCATGTAGTAGTA	PL-vir1
TACTCATGTGTCGCTG	PL-Inos
TACTCATTCCCAGGTG	PL-0
TACTCGCAGCAGCGTA	PL-0
TACTCGCAGCTAGTCT	PL-2
TACTCGCAGGCAGTCA	PL-0
TACTCGCAGTACGCGA	PL-1
TACTCGCAGTGGTAGC	PL-1
TACTCGCCAAAGGAAG	PL-Rel
TACTCGCCAATGGTCT	PL-3
TACTCGCCACCAGGTC	PL-Rel
TACTCGCCACGAGGTA	PL-1
TACTCGCCACGGACAA	PL-Rel
TACTCGCCACGGTTTA	PL-2
TACTCGCCAGGATCGA	PL-2
TACTCGCCATTGGCGC	PL-0
TACTCGCCATTGTGCA	PL-3
TACTCGCGTCACCCAG	PL-0
TACTCGCGTTCGCGAC	PL-2
TACTCGCTCACCTCGT	PL-3
TACTCGCTCCTGTACC	PL-0
TACTCGCTCCTTGCCA	PL-Pcd
TACTCGCTCTGAGTGT	PL-Rel
TACTCGCTCTGCGTAA	PL-0
TACTCGCTCTTGCAAG	PL-robo2
TACTTACAGACTACAA	PL-0
TACTTACAGGCAGGTT	PL-Lsp
TACTTACCACGCGAAA	PL-2
TACTTACCAGATGGGT	PL-Inos
TACTTACCAGCATACT	PL-0
TACTTACCATTGAGCT	PL-3
TACTTACGTAAAGTCA	PL-1
TACTTACGTCCAAGTT	PL-Rel
TACTTACGTCGGCTCA	PL-Rel
TACTTACGTCTGGTCG	PL-1
TACTTACGTGTTTGTG	PL-3
TACTTACGTTCCCTTG	PL-robo2
TACTTACTCACCGGGT	PL-Rel
TACTTACTCCGCTGTT	PL-Rel
TACTTACTCTGCGTAA	PL-3
TACTTGTAGAGGTACC	PL-0
TACTTGTAGAGTCTGG	PL-vir1
TACTTGTAGGCTAGCA	PL-1
TACTTGTAGTCCGGTC	PL-ImpL2
TACTTGTAGTGCCATT	PL-Rel
TACTTGTCAAGTTAAG	PL-2
TACTTGTCACGGTTTA	PL-prolif
TACTTGTCATGGATGG	PL-2
TACTTGTGTAGCTTGT	PL-Pcd
TACTTGTGTCAGTGGA	PL-Rel
TACTTGTGTCCGAATT	PL-0
TACTTGTGTGTGCGTC	PL-1
TACTTGTTCACGCGGT	PL-Rel
TACTTGTTCCGTTGCT	PL-2
TACTTGTTCGTCGTTC	PL-robo2
TACTTGTTCGTTTATC	PL-robo2
TACTTGTTCTCCGGTT	PL-robo2
TAGACCAAGAGTGAGA	PL-Rel
TAGACCACAAGAGTCG	PL-Inos
TAGACCACAATAGCAA	PL-0
TAGACCACAATGGAAT	PL-2
TAGACCACAGTCAGAG	PL-3
TAGACCACATCATCCC	PL-Pcd
TAGACCAGTAAGTGGC	PL-Rel
TAGACCAGTACCGGCT	PL-0
TAGACCAGTATATGGA	PL-Rel
TAGACCAGTCCGAGTC	PL-Lsp
TAGACCAGTTCTCATT	PL-2
TAGACCAGTTGCGCAC	PL-2
TAGACCATCGGTGTCG	PL-Rel
TAGAGCTAGACAATAC	PL-0
TAGAGCTAGATCGGGT	PL-2
TAGAGCTAGATGTCGG	PL-Rel
TAGAGCTCACGAAGCA	PL-Rel
TAGAGCTGTAAAGTCA	PL-vir1
TAGAGCTGTACCTACA	PL-3
TAGAGCTGTATCAGTC	PL-Lsp
TAGAGCTGTCACAAGG	PL-1
TAGAGCTGTTCCGGCA	PL-2
TAGAGCTGTTTGACTG	PL-Rel
TAGAGCTTCATATCGG	PL-0
TAGAGCTTCATGTCTT	PL-3
TAGAGCTTCGCCTGTT	PL-2
TAGCCGGAGCCCAGCT	PL-2
TAGCCGGAGCGTTTAC	PL-3
TAGCCGGAGGACGAAA	PL-Rel
TAGCCGGCAAATACAG	PL-2
TAGCCGGCAAGTTCTG	PL-Pcd
TAGCCGGCACGAAACG	PL-robo2
TAGCCGGCACGGTAGA	PL-Lsp
TAGCCGGCAGTTCATG	PL-robo2
TAGCCGGCATACGCTA	PL-0
TAGCCGGCATTGCGGC	PL-Pcd
TAGCCGGGTAGCGCAA	PL-2
TAGCCGGGTAGTACCT	PL-0
TAGCCGGGTATGAAAC	PL-Rel
TAGCCGGGTCTTGCGG	PL-0
TAGCCGGGTGTGGCTC	PL-2
TAGCCGGGTTCCCTTG	PL-0
TAGCCGGGTTGTCGCG	PL-0
TAGCCGGTCATTTGGG	PL-2
TAGCCGGTCCTCTAGC	PL-3
TAGGCATAGCACCGCT	PL-Pcd
TAGGCATAGCCGATTT	PL-0
TAGGCATAGGGATACC	PL-0
TAGGCATCAACACCCG	PL-1
TAGGCATCACGGTAAG	PL-Lsp
TAGGCATCACGGTAGA	PL-Pcd
TAGGCATCAGGAATCG	PL-robo2
TAGGCATGTGAGGGAG	PL-1
TAGGCATGTTCGGGCT	PL-1
TAGGCATTCGGACAAG	PL-1
TAGGCATTCTACGAGT	PL-1
TAGGCATTCTGCGTAA	PL-Rel
TAGTGGTAGTGGAGAA	PL-2
TAGTGGTAGTGTACTC	PL-2
TAGTGGTAGTTACCCA	PL-1
TAGTGGTCACACATGT	PL-Rel
TAGTGGTCACATGACT	PL-3
TAGTGGTCATTGGCGC	PL-0
TAGTGGTGTGCACTTA	PL-0
TAGTGGTGTTGAGGTG	PL-1
TAGTGGTTCCAAGTAC	PL-3
TAGTGGTTCGGTTAAC	PL-1
TAGTGGTTCTGCGACG	PL-robo2
TAGTTGGAGAGAACAG	PL-2
TAGTTGGAGCCGCCTA	PL-2
TAGTTGGAGCGCCTTG	PL-1
TAGTTGGAGCGTTTAC	PL-Pcd
TAGTTGGAGCTAGTTC	PL-0
TAGTTGGAGCTGCCCA	PL-vir1
TAGTTGGAGGTGCAAC	PL-Rel
TAGTTGGAGTCATGCT	PL-0
TAGTTGGCAATCACAC	PL-2
TAGTTGGCACCCATTC	CC
TAGTTGGCACGAAGCA	PL-Pcd
TAGTTGGCACGCCAGT	PL-1
TAGTTGGCAGGCGATA	PL-1
TAGTTGGGTCCCTACT	PL-Rel
TAGTTGGTCATCACCC	PL-Rel
TAGTTGGTCCACGCAG	PL-0
TAGTTGGTCGTACGGC	PL-robo2
TAGTTGGTCGTCTGCT	PL-0
TAGTTGGTCTATCCTA	PL-0
TATCAGGAGATAGGAG	PL-0
TATCAGGAGTACTTGC	PL-1
TATCAGGAGTTTCCTT	PL-0
TATCAGGCAAACGTGG	PL-Pcd
TATCAGGCATAGTAAG	PL-Pcd
TATCAGGCATCCCATC	PL-Inos
TATCAGGGTAAGCACG	PL-2
TATCAGGGTAGAAAGG	PL-Pcd
TATCAGGGTAGCGTCC	PL-0
TATCAGGGTCGCGGTT	PL-1
TATCAGGGTGAGCGAT	PL-1
TATCAGGGTGCGCTTG	PL-Lsp
TATCAGGGTTCCACGG	PL-3
TATCAGGGTTTGGCGC	PL-Inos
TATCAGGTCGCCAGCA	PL-1
TATCTCAAGAAGAAGC	PL-Pcd
TATCTCAAGATCGGGT	PL-1
TATCTCAAGCTCTCGG	PL-vir1
TATCTCAAGTGCGTGA	PL-3
TATCTCACAGCCTATA	PL-Pcd
TATCTCACATGTAAGA	PL-0
TATCTCAGTAGCAAAT	PL-Pcd
TATCTCAGTATTCGTG	PL-2
TATCTCAGTCCAGTGC	PL-0
TATCTCAGTCCGTTAA	PL-0
TATCTCAGTCGAAAGC	PL-3
TATCTCAGTGCACCAC	PL-2
TATCTCAGTTTGTTGG	PL-3
TATCTCATCGGGAGTA	PL-vir1
TATCTCATCTGGGCCA	PL-vir1
TATCTCATCTGTCAAG	PL-Rel
TATGCCCAGAAGGACA	PL-2
TATGCCCAGCCCTAAT	PL-1
TATGCCCAGCGCTTAT	PL-3
TATGCCCAGGAATGGA	PL-2
TATGCCCAGGATATAC	PL-robo2
TATGCCCCAAGCGTAG	PL-0
TATGCCCCAAGGACAC	PL-0
TATGCCCCAATGGATA	PL-2
TATGCCCCACTCTGTC	PL-2
TATGCCCCAGGACCCT	PL-2
TATGCCCGTAGGAGTC	PL-0
TATGCCCTCTGTACGA	PL-3
TATTACCAGCCGGTAA	PL-1
TATTACCAGCGATAGC	PL-Pcd
TATTACCAGGATGGTC	PL-1
TATTACCAGGGCTCTC	PL-0
TATTACCAGGTGACCA	PL-Inos
TATTACCAGGTGATAT	PL-Inos
TATTACCAGGTGCAAC	PL-0
TATTACCCACCCATGG	PL-AMP
TATTACCCACGCCAGT	PL-vir1
TATTACCCACGCTTTC	PL-Pcd
TATTACCCACTTCGAA	PL-Lsp
TATTACCGTAGGGACT	PL-1
TATTACCGTCCGAATT	PL-1
TATTACCGTCGAGTTT	PL-Inos
TATTACCGTGTGCCTG	PL-2
TATTACCGTTCAGCGC	PL-2
TATTACCTCAACACTG	PL-Rel
TATTACCTCAACGAAA	PL-Rel
TATTACCTCCACGTGG	PL-Rel
TATTACCTCGCCGTGA	PL-robo2
TCAACGAAGAACAATC	PL-0
TCAACGAAGACACTAA	PL-3
TCAACGAAGCCTCGTG	PL-Inos
TCAACGAAGGTAGCTG	PL-2
TCAACGAAGGTGCACA	PL-0
TCAACGACAACTTGAC	PL-robo2
TCAACGACAAGCGTAG	PL-1
TCAACGACATCCGTGG	PL-robo2
TCAACGACATTACGAC	PL-Rel
TCAACGAGTATATGAG	PL-1
TCAACGAGTCATACTG	PL-0
TCAACGAGTCCGTTAA	PL-0
TCAACGAGTGCATCTA	PL-2
TCAACGAGTGTCAATC	PL-vir1
TCAACGATCAAACCAC	PL-Lsp
TCAACGATCACGATGT	PL-1
TCAACGATCGCACTCT	PL-3
TCAACGATCGGAGGTA	PL-Lsp
TCAATCTAGCGCTCCA	PL-1
TCAATCTAGGCTATCT	PL-3
TCAATCTAGTGATCGG	PL-3
TCAATCTAGTTTCCTT	PL-1
TCAATCTCAAGAGGCT	PL-1
TCAATCTCAATCAGAA	PL-2
TCAATCTCACGGCCAT	PL-Rel
TCAATCTCATATACGC	PL-3
TCAATCTCATGCTAGT	PL-Lsp
TCAATCTGTATAGGGC	PL-0
TCAATCTGTCTTCAAG	PL-0
TCAATCTGTCTTGTCC	PL-robo2
TCAATCTGTGGAAAGA	PL-2
TCAATCTGTGTGGTTT	PL-Inos
TCAATCTTCATCGATG	PL-1
TCAATCTTCATGTGGT	PL-1
TCAATCTTCCAAAGTC	PL-1
TCAATCTTCTATCCTA	PL-1
TCACAAGAGGGTTCCC	PL-robo2
TCACAAGAGTTCGATC	PL-1
TCACAAGCACAGCGTC	PL-1
TCACAAGCAGAAGCAC	PL-Rel
TCACAAGCAGGGCATA	PL-Rel
TCACAAGCATAGAAAC	PL-0
TCACAAGGTATATGGA	PL-2
TCACAAGGTCATCCCT	PL-2
TCACAAGGTGACGCCT	PL-1
TCACAAGGTTGAACTC	PL-0
TCACAAGTCAAAGACA	PL-vir1
TCACAAGTCCACGTTC	PL-1
TCACAAGTCCTGTACC	PL-vir1
TCACAAGTCTTCAACT	PL-0
TCACGAAAGAACAATC	PL-1
TCACGAAAGTACGTAA	PL-3
TCACGAAAGTGTGAAT	PL-Lsp
TCACGAACAGCGAACA	PL-Rel
TCACGAACAGTTCATG	PL-0
TCACGAAGTAAATGAC	PL-Lsp
TCACGAAGTCGCCATG	PL-1
TCACGAAGTGCGCTTG	PL-1
TCACGAAGTTCAACCA	PL-Rel
TCACGAATCAGATAAG	PL-1
TCACGAATCATCGGAT	PL-1
TCACGAATCCGCATCT	PL-robo2
TCACGAATCGCAAGCC	PL-Pcd
TCAGATGAGCCCAACC	PL-0
TCAGATGAGCTCTCGG	PL-1
TCAGATGAGGCCCTCA	PL-2
TCAGATGAGTTAACGA	PL-3
TCAGATGCACACTGCG	PL-0
TCAGATGCAGGCTGAA	PL-3
TCAGATGCAGTTCATG	CC
TCAGATGGTACTCTCC	PL-0
TCAGATGGTACTTGAC	PL-0
TCAGATGGTATTCGTG	PL-Lsp
TCAGATGGTGACGGTA	PL-2
TCAGATGGTTAGAACA	PL-2
TCAGATGTCAAACAAG	PL-2
TCAGATGTCCCAAGTA	PL-Inos
TCAGATGTCCTCGCAT	PL-1
TCAGATGTCTGTCTAT	PL-1
TCAGCAAAGGCAGGTT	PL-1
TCAGCAAAGGGCATGT	PL-1
TCAGCAAAGGTGCAAC	PL-2
TCAGCAAAGTTGCAGG	PL-vir1
TCAGCAACAACGATGG	PL-2
TCAGCAACACGGACAA	PL-0
TCAGCAACAGGAACGT	PL-0
TCAGCAACATATACCG	PL-0
TCAGCAACATATACGC	PL-robo2
TCAGCAAGTAGGACAC	PL-Rel
TCAGCAAGTCGATTGT	PL-0
TCAGCAATCAACACAC	PL-1
TCAGCAATCAACTCTT	PL-1
TCAGCAATCATTTGGG	PL-1
TCAGCAATCCAGAGGA	PL-1
TCAGCAATCCTAGTGA	PL-3
TCAGCAATCGGAGGTA	PL-0
TCAGCTCAGACCTAGG	PL-2
TCAGCTCAGATCGATA	PL-0
TCAGCTCAGCAATCTC	PL-0
TCAGCTCAGCCCAGCT	PL-0
TCAGCTCAGGCCGAAT	PL-Rel
TCAGCTCAGTGTCTCA	PL-robo2
TCAGCTCCAAGTTGTC	PL-robo2
TCAGCTCCAATAGAGT	PL-1
TCAGCTCCACAACGTT	PL-Inos
TCAGCTCCACTATCTT	PL-0
TCAGCTCCAGCATGAG	PL-0
TCAGCTCCAGCTATTG	PL-Pcd
TCAGCTCCAGCTGTAT	PL-2
TCAGCTCCATGATCCA	PL-0
TCAGCTCGTAGAAAGG	PL-0
TCAGCTCGTCAGAAGC	PL-Inos
TCAGCTCGTCAGCTAT	PL-0
TCAGCTCGTTCGTCTC	PL-vir1
TCAGCTCTCAAACGGG	PL-robo2
TCAGCTCTCCGAGCCA	PL-0
TCAGCTCTCGAATCCA	PL-0
TCAGCTCTCTACTTAC	PL-2
TCAGGATAGAACAACT	PL-vir1
TCAGGATAGATCTGAA	PL-2
TCAGGATAGCGTGAAC	PL-0
TCAGGATAGGCGACAT	PL-1
TCAGGATAGGTCGGAT	PL-0
TCAGGATCAAGCGAGT	LM-1
TCAGGATCACTTCTGC	PL-0
TCAGGATCATACTACG	PL-1
TCAGGATCATGGTCAT	PL-2
TCAGGATGTCCATCCT	PL-vir1
TCAGGATGTGACTACT	PL-1
TCAGGATTCGCGCCAA	PL-robo2
TCAGGATTCTGCCCTA	PL-Inos
TCAGGTAAGCAGCGTA	PL-0
TCAGGTAAGCCCAATT	PL-robo2
TCAGGTAAGTGGCACA	PL-Inos
TCAGGTACAATGGTCT	PL-1
TCAGGTACACCTATCC	PL-Pcd
TCAGGTACAGTCAGCC	PL-0
TCAGGTACATCATCCC	PL-1
TCAGGTAGTAAGCACG	PL-0
TCAGGTAGTAGATTAG	PL-3
TCAGGTAGTAGCGCTC	PL-1
TCAGGTAGTAGGACAC	PL-Rel
TCAGGTAGTCCAACTA	PL-0
TCAGGTAGTCCTCCAT	PL-0
TCAGGTAGTCGGGTCT	PL-Rel
TCAGGTAGTTATCGGT	PL-0
TCAGGTAGTTTGGGCC	PL-2
TCAGGTATCCCACTTG	PL-Pcd
TCAGGTATCCGCGGTA	PL-1
TCATTACAGACGCACA	PL-2
TCATTACCAAATCCGT	PL-Rel
TCATTACGTAGCGTCC	PL-vir1
TCATTACGTCGAATCT	PL-0
TCATTACGTCTAAAGA	PL-0
TCATTACGTGTGGCTC	PL-0
TCATTACGTTCGGCAC	PL-Pcd
TCATTACTCAAACAAG	PL-Pcd
TCATTACTCATGCATG	PL-Rel
TCATTACTCCTCCTAG	PL-2
TCATTACTCCTCGCAT	PL-robo2
TCATTACTCTCGCATC	PL-AMP
TCATTTGAGAAACCTA	PL-0
TCATTTGAGGCCCTTG	PL-2
TCATTTGAGTGCCATT	PL-0
TCATTTGAGTTGCAGG	PL-3
TCATTTGCAAGTCTGT	PL-0
TCATTTGCATCCTTGC	PL-0
TCATTTGCATGCCACG	PL-0
TCATTTGCATTGCGGC	PL-Rel
TCATTTGGTATTAGCC	PL-2
TCATTTGGTCCGACGT	PL-2
TCATTTGGTGATGTCT	PL-2
TCATTTGGTGTATGGG	PL-0
TCATTTGGTTGGTAAA	PL-0
TCATTTGGTTGTCTTT	PL-2
TCATTTGTCTGCAGTA	PL-1
TCCACACAGAGAACAG	PL-0
TCCACACAGGACAGAA	PL-3
TCCACACAGTAGATGT	PL-Pcd
TCCACACCACATTTCT	PL-2
TCCACACCAGATAATG	PL-2
TCCACACGTATCGCAT	PL-Rel
TCCACACGTCCGACGT	PL-0
TCCACACGTGCCTGCA	PL-Rel
TCCACACGTTAAGACA	PL-2
TCCACACGTTATCACG	PL-Lsp
TCCACACTCAGGCAAG	PL-3
TCCACACTCTGGTGTA	PL-1
TCCCGATAGCTGTCTA	PL-Rel
TCCCGATAGGATATAC	PL-3
TCCCGATAGGCCCGTT	PL-Rel
TCCCGATCACCTGGTG	PL-2
TCCCGATCATCCGTGG	PL-1
TCCCGATCATGCCTAA	PL-1
TCCCGATGTAAGTTCC	PL-1
TCCCGATGTAGCTGCC	PL-1
TCCCGATGTCAGATAA	PL-2
TCCCGATGTGTCTGAT	PL-3
TCCCGATTCAACACTG	PL-1
TCCCGATTCAGAAATG	PL-0
TCCCGATTCATCGATG	PL-Lsp
TCCCGATTCCTGCAGG	PL-0
TCCCGATTCGGCTTGG	PL-3
TCGAGGCAGATAGTCA	PL-1
TCGAGGCCAATGGAGC	PL-3
TCGAGGCCACCTATCC	PL-1
TCGAGGCCAGATTGCT	PL-Rel
TCGAGGCCATGGTCTA	PL-AMP
TCGAGGCGTATCGCAT	PL-Rel
TCGAGGCGTCTGATTG	LM-1
TCGAGGCGTGAGGGAG	PL-1
TCGAGGCGTGCCTGCA	PL-1
TCGAGGCTCACCACCT	PL-Rel
TCGAGGCTCATCATTC	PL-3
TCGAGGCTCGAGAACG	PL-2
TCGAGGCTCTACGAGT	PL-vir1
TCGCGAGCAGCCTGTG	PL-0
TCGCGAGCAGTCAGCC	PL-Rel
TCGCGAGGTAATCACC	PL-0
TCGCGAGGTTCAGCGC	PL-1
TCGCGAGGTTTAGCTG	PL-0
TCGCGAGGTTTGTGTG	PL-2
TCGCGAGTCCTGTAGA	PL-0
TCGCGAGTCGCCATAA	PL-robo2
TCGCGTTAGACAAGCC	PL-2
TCGCGTTAGCCAGTAG	PL-0
TCGCGTTAGGGATACC	PL-2
TCGCGTTAGGTACTCT	PL-2
TCGCGTTAGTAACCCT	PL-robo2
TCGCGTTCAAACCCAT	PL-Inos
TCGCGTTCAAGCTGGA	PL-0
TCGCGTTCAAGCTGTT	PL-Rel
TCGCGTTCAAGTAATG	PL-robo2
TCGCGTTCAAGTCTAC	PL-0
TCGCGTTCACGAAGCA	PL-vir1
TCGCGTTCAGGAATCG	PL-3
TCGCGTTGTCATATCG	PL-2
TCGCGTTGTTTCCACC	PL-2
TCGCGTTTCAAGGTAA	PL-1
TCGCGTTTCGCAAGCC	PL-0
TCGGGACAGACTACAA	PL-0
TCGGGACAGGAGTTTA	PL-Rel
TCGGGACAGGATCGCA	PL-1
TCGGGACCAGTAACGG	PL-3
TCGGGACCATTTCACT	PL-1
TCGGGACGTGAAATCA	PL-1
TCGGGACGTGGCCCTA	PL-robo2
TCGGGACTCGCCATAA	PL-Rel
TCGGGACTCGTAGGAG	PL-2
TCGGTAAAGACAGAGA	PL-0
TCGGTAAAGAGGGATA	PL-Rel
TCGGTAAAGCCCAATT	PL-2
TCGGTAAAGTAGTGCG	PL-Rel
TCGGTAAAGTGACATA	PL-0
TCGGTAAAGTTAGCGG	PL-1
TCGGTAACAATAACGA	PL-1
TCGGTAACACGGCGTT	PL-Pcd
TCGGTAAGTAAGTGTA	PL-Lsp
TCGGTAAGTCATTAGC	PL-0
TCGGTAAGTCTCCACT	PL-0
TCGGTAAGTTCCACTC	PL-Pcd
TCGGTAATCACGAAGG	PL-1
TCGGTAATCACTCCTG	PL-vir1
TCGGTAATCAGCGACC	PL-robo2
TCGGTAATCCTAGGGC	PL-3
TCGGTAATCTAGCACA	PL-Inos
TCGTACCAGATCTGAA	PL-0
TCGTACCAGGGTTCCC	PL-2
TCGTACCAGGTCGGAT	PL-3
TCGTACCAGTCAAGGC	PL-0
TCGTACCGTAGATTAG	PL-0
TCGTACCGTAGGCTGA	PL-2
TCGTACCGTATCAGTC	PL-robo2
TCGTACCGTTAAGTAG	PL-0
TCGTACCTCATGCTCC	PL-vir1
TCGTACCTCCGATATG	PL-2
TCGTACCTCCGTCAAA	PL-1
TCGTACCTCTTCTGGC	PL-Pcd
TCGTACCTCTTTAGTC	PL-Rel
TCGTAGAAGATATGCA	PL-Pcd
TCGTAGAAGCCAACAG	PL-vir1
TCGTAGAAGCCGATTT	PL-2
TCGTAGAAGGAGTACC	PL-0
TCGTAGACACGTCTCT	PL-1
TCGTAGACACGTGAGA	PL-Pcd
TCGTAGACAGCCTGTG	PL-Rel
TCGTAGACATGAGCGA	PL-1
TCGTAGAGTGACCAAG	PL-Lsp
TCGTAGAGTGCATCTA	PL-vir1
TCGTAGAGTGTTGGGA	PL-Pcd
TCGTAGATCCAACCAA	PL-Rel
TCGTAGATCCAGAGGA	PL-2
TCGTAGATCGGATGGA	PL-Pcd
TCGTAGATCTACCTGC	PL-robo2
TCGTAGATCTCTAAGG	PL-3
TCGTAGATCTCTTATG	PL-0
TCTATTGAGATCCCAT	PL-Rel
TCTATTGAGATCGATA	PL-Rel
TCTATTGAGCAACGGT	PL-0
TCTATTGAGGTCGGAT	PL-vir1
TCTATTGAGGTGTTAA	PL-0
TCTATTGAGTCCATAC	PL-Inos
TCTATTGCACATTAGC	PL-Rel
TCTATTGCATATACGC	PL-Rel
TCTATTGCATGGAATA	PL-2
TCTATTGGTAAGTTCC	PL-0
TCTATTGGTCAACTGT	PL-3
TCTATTGTCAAACAAG	PL-0
TCTATTGTCCACTCCA	PL-0
TCTATTGTCGTTTGCC	PL-1
TCTATTGTCTCAAGTG	PL-Rel
TCTCATAAGATCCGAG	PL-vir1
TCTCATACATTCACTT	PL-1
TCTCATAGTACCGAGA	PL-2
TCTCATAGTAGCGCAA	PL-1
TCTCATAGTCCTAGCG	PL-3
TCTCATATCAGTCAGT	PL-2
TCTCATATCATCGCTC	PL-1
TCTCATATCATTATCC	PL-vir1
TCTCATATCCGAGCCA	PL-0
TCTCATATCTTACCGC	PL-vir1
TCTCTAAAGAAGGCCT	PL-1
TCTCTAAAGATATGCA	PL-2
TCTCTAAAGCTAACTC	PL-1
TCTCTAAAGGGTATCG	PL-1
TCTCTAAAGTTCGATC	PL-2
TCTCTAACAAGTTAAG	PL-Inos
TCTCTAACAATCCGAT	PL-1
TCTCTAACACCGAAAG	PL-Lsp
TCTCTAACACCTGGTG	PL-1
TCTCTAACAGACAAAT	PL-2
TCTCTAACAGGTTTCA	PL-1
TCTCTAACATCCGGGT	PL-vir1
TCTCTAAGTACTTCTT	PL-2
TCTCTAAGTCAGAGGT	PL-Pcd
TCTCTAAGTTCCAACA	PL-2
TCTCTAATCACCAGGC	PL-3
TCTCTAATCATACGGT	PL-0
TCTCTAATCCCGGATG	PL-Rel
TCTCTAATCCTGTACC	PL-3
TCTCTAATCCTTGGTC	PL-vir1
TCTCTAATCGCCAGCA	PL-0
TCTCTAATCGCCTGTT	PL-vir1
TCTCTAATCGTGGTCG	PL-1
TCTCTAATCTTTACAC	PL-1
TCTGAGAAGTCGATAA	PL-1
TCTGAGAAGTTGAGTA	PL-2
TCTGAGACAACGATCT	PL-0
TCTGAGACAATAGCGG	PL-0
TCTGAGACACGTCTCT	PL-3
TCTGAGACATGAACCT	PL-0
TCTGAGACATTTCACT	PL-prolif
TCTGAGATCAAGAAGT	PL-0
TCTGAGATCGGATGGA	PL-0
TCTGAGATCGTTACAG	PL-3
TCTGAGATCTTGGGTA	PL-0
TCTGGAAAGAGCTGGT	PL-1
TCTGGAAAGATGTCGG	PL-3
TCTGGAAAGTCATGCT	PL-vir1
TCTGGAACAGTATGCT	PL-robo2
TCTGGAACATTCGACA	PL-2
TCTGGAAGTACTTCTT	PL-robo2
TCTGGAAGTCGAAAGC	PL-robo2
TCTGGAATCACAGTAC	PL-3
TCTGGAATCAGGCGAA	PL-Rel
TCTGGAATCGGTTAAC	PL-Pcd
TCTTCGGAGAGACTAT	PL-2
TCTTCGGAGAGGTACC	PL-Rel
TCTTCGGAGATTACCC	PL-1
TCTTCGGAGCTGATAA	PL-2
TCTTCGGAGTATCGAA	PL-1
TCTTCGGCAAAGCGGT	PL-0
TCTTCGGCAATCACAC	CC
TCTTCGGCAATCCGAT	PL-0
TCTTCGGCACCCAGTG	PL-1
TCTTCGGCAGCATGAG	PL-Pcd
TCTTCGGCAGCCTTGG	PL-0
TCTTCGGCAGCTATTG	PL-1
TCTTCGGCATCTCCCA	PL-0
TCTTCGGGTACATCCA	PL-3
TCTTCGGGTATGCTTG	PL-2
TCTTCGGGTCATATCG	PL-3
TCTTCGGGTCGAACAG	PL-3
TCTTCGGGTCGTGGCT	PL-3
TCTTCGGTCAAGGTAA	PL-2
TCTTCGGTCATGCATG	PL-0
TCTTCGGTCCTCATTA	PL-Inos
TCTTCGGTCCTTGCCA	PL-0
TCTTCGGTCTGAGGGA	PL-2
TCTTCGGTCTGTGCAA	PL-1
TCTTTCCAGAAACCGC	PL-0
TCTTTCCAGCCGTCGT	PL-1
TCTTTCCCAGCAGTTT	PL-0
TCTTTCCCAGCTGCTG	PL-0
TCTTTCCGTAAGTAGT	PL-3
TCTTTCCGTCGAGATG	PL-1
TCTTTCCTCACCCGAG	PL-2
TCTTTCCTCCCTTGCA	PL-1
TCTTTCCTCCTCAATT	PL-3
TCTTTCCTCGTCACGG	PL-3
TCTTTCCTCTAGCACA	PL-0
TCTTTCCTCTATCCTA	PL-2
TCTTTCCTCTTAGCCC	PL-3
TCTTTCCTCTTATCTG	PL-0
TCTTTCCTCTTTACAC	PL-Rel
TGAAAGAAGAGTCGGT	PL-0
TGAAAGAAGTCTCCTC	PL-0
TGAAAGAAGTGAAGAG	PL-3
TGAAAGACACTGAAGG	PL-0
TGAAAGACAGGTGGAT	PL-Rel
TGAAAGACATATACGC	PL-AMP
TGAAAGACATCTACGA	PL-vir1
TGAAAGAGTACCGAGA	PL-1
TGAAAGAGTCTAGTCA	PL-1
TGAAAGAGTGCCTTGG	PL-2
TGAAAGAGTTTGACTG	PL-Rel
TGAAAGAGTTTGTGTG	PL-Rel
TGAAAGATCCACGACG	PL-0
TGAAAGATCCTTTCTC	PL-2
TGAAAGATCGAGAGCA	PL-1
TGAAAGATCTCAACTT	PL-Rel
TGAAAGATCTGTCTAT	PL-1
TGAAAGATCTTGTACT	PL-1
TGACAACAGATGGCGT	PL-2
TGACAACAGCATGGCA	PL-robo2
TGACAACAGCCACGTC	PL-Inos
TGACAACAGTGGTAGC	PL-1
TGACAACCAATAGCAA	PL-0
TGACAACCAGCCAGAA	PL-robo2
TGACAACCAGCTATTG	PL-robo2
TGACAACCAGTACACT	PL-2
TGACAACCATCAGTCA	PL-Pcd
TGACAACCATCTCCCA	PL-1
TGACAACGTCCAGTTA	PL-0
TGACAACGTGACAAAT	PL-Rel
TGACAACGTGCGATAG	PL-Inos
TGACAACGTTCCTCCA	PL-Rel
TGACAACGTTGTCGCG	PL-2
TGACGGCAGGGCTTCC	PL-2
TGACGGCAGGTAGCCA	PL-2
TGACGGCCAGTTCATG	PL-0
TGACGGCGTAAGCACG	PL-robo2
TGACGGCGTTCCTCCA	PL-Pcd
TGACGGCTCAACACCA	PL-1
TGACGGCTCAACCATG	PL-2
TGACGGCTCGTATCAG	PL-0
TGACTAGAGATGCCTT	PL-1
TGACTAGAGCTGAACG	PL-2
TGACTAGAGGACGAAA	PL-robo2
TGACTAGAGGGTTTCT	PL-Pcd
TGACTAGCAATGTAAG	PL-2
TGACTAGCATCCCATC	PL-Lsp
TGACTAGGTAGCTGCC	PL-0
TGACTAGGTCCCTTGT	PL-0
TGACTAGGTTCCATGA	PL-0
TGACTAGGTTCCGGCA	PL-2
TGACTAGTCATAACCG	PL-Rel
TGACTAGTCTCTTGAT	PL-Rel
TGACTAGTCTGCCCTA	PL-0
TGACTAGTCTGCGTAA	PL-0
TGACTTTAGATCGATA	PL-Rel
TGACTTTAGGAATTAC	PL-1
TGACTTTAGGCAATTA	PL-vir1
TGACTTTAGGGTGTTG	PL-0
TGACTTTAGGTCATCT	PL-Rel
TGACTTTAGTGACATA	PL-1
TGACTTTCAGAAGCAC	PL-Inos
TGACTTTGTAAGTTCC	PL-1
TGACTTTGTAGCGCAA	PL-0
TGACTTTGTCAAGCGA	PL-1
TGACTTTGTCGGCATC	PL-0
TGACTTTGTCTTCGTC	PL-Rel
TGACTTTGTTGTGGCC	PL-2
TGACTTTTCACGATGT	PL-vir1
TGACTTTTCATTGCGA	PL-1
TGACTTTTCCACGTGG	PL-Rel
TGACTTTTCGGCTACG	PL-Rel
TGACTTTTCTGGCGTG	PL-Rel
TGAGAGGAGAACTCGG	PL-Inos
TGAGAGGAGTTCGCGC	PL-2
TGAGAGGCAGGCTCAC	PL-1
TGAGAGGCATATACCG	PL-robo2
TGAGAGGGTAAACCTC	PL-2
TGAGAGGGTATATGAG	PL-0
TGAGAGGGTCTAGTCA	PL-1
TGAGAGGGTGCGGTAA	PL-2
TGAGAGGTCTCGAGTA	PL-Rel
TGAGAGGTCTCTAAGG	PL-1
TGAGAGGTCTTGTTTG	PL-0
TGAGCATAGGGCTTGA	PL-0
TGAGCATAGGGTCTCC	PL-2
TGAGCATAGTGTTTGC	PL-1
TGAGCATAGTTCGCAT	PL-0
TGAGCATCAGAGCCAA	PL-Rel
TGAGCATCATTCTTAC	PL-Rel
TGAGCATGTAGGGTAC	PL-vir1
TGAGCATGTATAGTAG	PL-2
TGAGCATGTCGTTGTA	PL-1
TGAGCATGTGCAACGA	PL-2
TGAGCATGTTAAGTAG	PL-1
TGAGCATGTTAGTGGG	PL-robo2
TGAGCATTCAATAAGG	PL-Rel
TGAGCATTCACATAGC	PL-1
TGAGCATTCGATAGAA	PL-2
TGAGCATTCGCAAGCC	PL-0
TGAGCATTCTTGAGAC	PL-Lsp
TGAGCATTCTTTAGTC	PL-1
TGAGCCGAGCTACCGC	PL-robo2
TGAGCCGAGGACCACA	PL-Inos
TGAGCCGAGGCATGGT	PL-1
TGAGCCGAGGTAGCCA	PL-1
TGAGCCGCAATAAGCA	PL-Inos
TGAGCCGCATCGTCGG	PL-2
TGAGCCGGTACAAGTA	PL-2
TGAGCCGGTAGCACGA	PL-1
TGAGCCGGTATAAACG	PL-Inos
TGAGCCGGTATCACCA	PL-0
TGAGCCGGTGATGCCC	PL-1
TGAGCCGGTGTCCTCT	PL-0
TGAGCCGTCGCACTCT	PL-0
TGAGGGAAGGAGTCTG	PL-1
TGAGGGACAAAGTGCG	PL-Rel
TGAGGGACACATCTTT	PL-Rel
TGAGGGACACCGAATT	PL-1
TGAGGGAGTGATAAGT	PL-0
TGAGGGAGTTGTTTGG	PL-robo2
TGAGGGATCAAACCGT	PL-1
TGAGGGATCTGCTTGC	PL-1
TGATTTCAGAGGTTAT	PL-2
TGATTTCAGGGATCTG	PL-Rel
TGATTTCAGTCGATAA	PL-3
TGATTTCCACCAGGTC	PL-vir1
TGATTTCCACTTCTGC	PL-2
TGATTTCCAGACAAGC	PL-0
TGATTTCCATGATCCA	PL-1
TGATTTCCATGGGACA	PL-Inos
TGATTTCGTACGCACC	PL-2
TGATTTCGTCTAGTGT	PL-Pcd
TGATTTCGTGCAGGTA	PL-Rel
TGATTTCGTGCCTGGT	PL-Lsp
TGATTTCGTTTCGCTC	PL-0
TGATTTCTCACTCTTA	PL-2
TGATTTCTCATGGTCA	PL-Rel
TGATTTCTCTGTCAAG	PL-0
TGATTTCTCTTCATGT	PL-prolif
TGCACCTAGAGGACGG	PL-3
TGCACCTAGAGTAATC	PL-robo2
TGCACCTAGATGTAAC	PL-Rel
TGCACCTAGTACTTGC	PL-2
TGCACCTCACCTCGGA	PL-Pcd
TGCACCTCACGAAGCA	PL-3
TGCACCTCAGATGAGC	PL-Rel
TGCACCTCAGCCTTGG	PL-Rel
TGCACCTCAGCTTAAC	PL-3
TGCACCTCAGGTGCCT	PL-2
TGCACCTCATCAGTCA	PL-0
TGCACCTCATGCCACG	PL-0
TGCACCTCATTAGGCT	PL-0
TGCACCTGTACATGTC	PL-1
TGCACCTGTACCGCTG	PL-0
TGCACCTGTAGCCTAT	PL-0
TGCACCTGTATAGGGC	PL-0
TGCACCTGTCATATGC	PL-0
TGCACCTGTCCGAACC	PL-0
TGCACCTGTCTGATCA	PL-2
TGCACCTGTGTTCTTT	PL-Rel
TGCACCTGTGTTGAGG	PL-1
TGCACCTTCAAGATCC	PL-vir1
TGCACCTTCATGTAGC	PL-0
TGCACCTTCGATGAGG	PL-0
TGCACCTTCTATCCCG	PL-0
TGCCAAAAGAAGCCCA	PL-0
TGCCAAAAGATGTAAC	PL-robo2
TGCCAAAAGTATCGAA	PL-3
TGCCAAAAGTCGATAA	PL-1
TGCCAAACAATCTGCA	PL-1
TGCCAAACAATGGAAT	PL-Rel
TGCCAAACACAAGACG	PL-0
TGCCAAACAGGTTTCA	PL-3
TGCCAAAGTACAGACG	PL-vir1
TGCCAAAGTACTCTCC	PL-robo2
TGCCAAAGTCAGCTAT	PL-Rel
TGCCAAAGTCGAGATG	PL-2
TGCCAAAGTCTAGGTT	PL-Rel
TGCCAAAGTGATGTCT	PL-0
TGCCAAAGTGTGAAAT	PL-Rel
TGCCAAAGTTGCGTTA	PL-1
TGCCAAATCCACTGGG	PL-1
TGCCAAATCCAGGGCT	PL-3
TGCCAAATCTTGTCAT	PL-2
TGCCCATAGACAAAGG	PL-0
TGCCCATAGTCGTTTG	PL-Rel
TGCCCATCAAAGGAAG	PL-Lsp
TGCCCATCAAGCTGTT	PL-3
TGCCCATCACGAGGTA	PL-Inos
TGCCCATCACTACAGT	PL-1
TGCCCATCAGACGCAA	PL-0
TGCCCATCAGGCTGAA	PL-0
TGCCCATCATGTTGAC	PL-1
TGCCCATGTAGCGCAA	PL-0
TGCCCATTCAAACAAG	PL-3
TGCCCATTCAAGATCC	PL-2
TGCCCATTCTGCGTAA	PL-Rel
TGCCCTAAGATGTCGG	PL-0
TGCCCTAAGCCAGTTT	PL-Rel
TGCCCTAAGCGATAGC	PL-3
TGCCCTAAGGCCCTTG	PL-2
TGCCCTAAGGCGCTCT	PL-2
TGCCCTAAGTTCGCGC	PL-0
TGCCCTACAAACGCGA	PL-0
TGCCCTACAATGTAAG	PL-1
TGCCCTAGTAGCAAAT	PL-robo2
TGCCCTAGTTCAGACT	PL-Rel
TGCCCTAGTTTACTCT	PL-Rel
TGCCCTATCCCTTGCA	PL-0
TGCCCTATCCGTTGTC	PL-0
TGCCCTATCTTGTCAT	PL-2
TGCGCAGAGAAACGCC	PL-1
TGCGCAGAGATCGATA	PL-2
TGCGCAGAGCGAAGGG	PL-Lsp
TGCGCAGAGCTACCTA	PL-1
TGCGCAGAGGATCGCA	PL-0
TGCGCAGAGGTGCACA	PL-1
TGCGCAGAGGTGTGGT	PL-3
TGCGCAGAGTTCCACA	PL-2
TGCGCAGCAAGTTCTG	PL-1
TGCGCAGCAATGAAAC	PL-Rel
TGCGCAGCACACATGT	PL-0
TGCGCAGCACCGTTGG	PL-robo2
TGCGCAGCAGGCGATA	PL-2
TGCGCAGCATTCGACA	PL-1
TGCGCAGGTCATGCAT	PL-1
TGCGCAGGTCGACTGC	PL-Pcd
TGCGCAGGTCGCGGTT	PL-robo2
TGCGCAGTCCAAACTG	PL-2
TGCGCAGTCGAATGCT	PL-3
TGCGCAGTCGGAGCAA	PL-2
TGCGCAGTCTCTGAGA	PL-1
TGCGGGTAGAGACTTA	PL-1
TGCGGGTAGCGCTTAT	PL-robo2
TGCGGGTAGCTACCGC	PL-Pcd
TGCGGGTAGCTGCGAA	PL-1
TGCGGGTAGGAATTAC	PL-0
TGCGGGTCAACTGGCC	PL-Pcd
TGCGGGTCACAAGACG	PL-robo2
TGCGGGTCACCTATCC	PL-2
TGCGGGTCACTGAAGG	PL-1
TGCGGGTCAGCAGTTT	PL-Pcd
TGCGGGTCATGAACCT	PL-0
TGCGGGTGTAGCGTCC	PL-0
TGCGGGTGTCAAACTC	PL-0
TGCGGGTGTCCCTTGT	PL-1
TGCGGGTGTCGTCTTC	PL-3
TGCGGGTGTCTTGCGG	PL-1
TGCGGGTGTTGAACTC	PL-2
TGCGGGTTCCGCATCT	PL-vir1
TGCGGGTTCGAATGCT	PL-1
TGCGGGTTCTTCCTTC	PL-1
TGCGTGGAGAAGGCCT	PL-0
TGCGTGGAGCACCGCT	PL-1
TGCGTGGAGGAGTAGA	PL-0
TGCGTGGAGGTGCTAG	PL-3
TGCGTGGCACATGACT	PL-0
TGCGTGGCAGACAAGC	PL-3
TGCGTGGCAGGCTCAC	PL-3
TGCGTGGCAGGTCTCG	PL-Rel
TGCGTGGCAGTAACGG	PL-1
TGCGTGGCATCCCATC	PL-1
TGCGTGGCATTCTCAT	PL-Pcd
TGCGTGGGTACTCAAC	PL-0
TGCGTGGGTACTCTCC	PL-2
TGCGTGGGTCCAGTGC	PL-1
TGCGTGGGTTAAAGTG	PL-Rel
TGCGTGGTCCTGTAGA	PL-1
TGCGTGGTCTATGTGG	PL-2
TGCGTGGTCTCTGAGA	PL-Rel
TGCTACCAGCGAAGGG	PL-1
TGCTACCAGGCTAGGT	PL-0
TGCTACCAGGGTCTCC	PL-Rel
TGCTACCAGGTCATCT	PL-0
TGCTACCAGTCAAGGC	PL-2
TGCTACCCAAAGGTGC	PL-vir1
TGCTACCCAACTGGCC	PL-Rel
TGCTACCCAATAGAGT	PL-robo2
TGCTACCCACGACTCG	PL-1
TGCTACCCAGTATGCT	PL-Rel
TGCTACCCATGCAATC	PL-AMP
TGCTACCGTCGCATCG	PL-3
TGCTACCGTGAGTATA	PL-0
TGCTACCGTTCCAACA	PL-3
TGCTACCTCAAGATCC	PL-3
TGCTACCTCGCCTGTT	PL-0
TGCTACCTCTACCAGA	CC
TGCTACCTCTGCAGTA	PL-3
TGCTACCTCTGTCTCG	PL-Inos
TGCTGCTAGAGACGAA	PL-vir1
TGCTGCTAGATCCGAG	PL-robo2
TGCTGCTAGCACACAG	PL-Lsp
TGCTGCTCACCCATGG	PL-Rel
TGCTGCTCAGGACCCT	PL-2
TGCTGCTCAGTTTACG	PL-1
TGCTGCTGTAGCGCAA	PL-Rel
TGCTGCTGTCCAGTTA	PL-3
TGCTGCTGTTCGTGAT	PL-1
TGCTGCTTCAACGGGA	PL-0
TGCTGCTTCAGCTCTC	PL-1
TGCTGCTTCAGCTGGC	PL-0
TGCTGCTTCCAGTATG	PL-vir1
TGCTGCTTCCCTCAGT	PL-0
TGCTGCTTCCTCTAGC	PL-3
TGCTGCTTCGGACAAG	PL-3
TGCTGCTTCGTGGTCG	PL-0
TGCTGCTTCTGAAAGA	PL-1
TGGACGCAGAATTCCC	PL-1
TGGACGCAGAGACGAA	PL-Pcd
TGGACGCAGCAGACTG	PL-Lsp
TGGACGCAGGACTGGT	PL-2
TGGACGCCAAGAGTCG	PL-vir1
TGGACGCCAAGTACCT	PL-2
TGGACGCCAATGTAAG	PL-vir1
TGGACGCCACCATGTA	PL-Inos
TGGACGCCACCGGAAA	PL-1
TGGACGCCACGAAAGC	PL-1
TGGACGCCACTAAGTC	PL-Inos
TGGACGCCACTTAAGC	PL-robo2
TGGACGCCATCAGTCA	PL-3
TGGACGCGTAAACCTC	PL-Pcd
TGGACGCGTAATCACC	PL-1
TGGACGCTCCTTTCGG	PL-Inos
TGGACGCTCGCTTAGA	PL-2
TGGACGCTCTCGATGA	PL-0
TGGACGCTCTGATTCT	PL-Lsp
TGGACGCTCTGTGCAA	PL-3
TGGCCAGAGACCGGAT	PL-2
TGGCCAGAGCCTCGTG	PL-Inos
TGGCCAGAGGTGTTAA	PL-Rel
TGGCCAGAGTGTCCCG	PL-vir1
TGGCCAGAGTTACGGG	PL-vir1
TGGCCAGCACGACGAA	PL-Lsp
TGGCCAGCATGTTCCC	PL-0
TGGCCAGGTCGAACAG	PL-2
TGGCCAGGTCTAACGT	PL-0
TGGCCAGGTCTTTCAT	PL-0
TGGCCAGGTTCACCTC	PL-1
TGGCCAGGTTGATTCG	PL-0
TGGCCAGGTTGTACAC	PL-2
TGGCCAGTCAAGGCTT	PL-0
TGGCCAGTCGCCATAA	PL-0
TGGCCAGTCGCTTAGA	PL-3
TGGCCAGTCTTGTATC	PL-1
TGGCGCAAGATCTGCT	PL-1
TGGCGCAAGCAATATG	PL-1
TGGCGCAAGGACGAAA	PL-0
TGGCGCAAGGGTTTCT	PL-2
TGGCGCAAGTACGCGA	PL-1
TGGCGCACAAGTCTAC	PL-2
TGGCGCACAGTATGCT	PL-2
TGGCGCACATCACCCT	PL-Pcd
TGGCGCACATTATCTC	PL-prolif
TGGCGCACATTCCTCG	PL-2
TGGCGCACATTTCACT	PL-Pcd
TGGCGCAGTACCGCTG	PL-2
TGGCGCATCAAACCAC	PL-1
TGGCGCATCAACCAAC	PL-0
TGGCTGGAGCGACGTA	PL-1
TGGCTGGAGCGGATCA	PL-0
TGGCTGGAGGATATAC	PL-1
TGGCTGGAGGATGTAT	PL-Rel
TGGCTGGAGGGCTTCC	PL-Rel
TGGCTGGAGTTAGGTA	PL-1
TGGCTGGCAACGATCT	PL-0
TGGCTGGCACGAGAGT	PL-0
TGGCTGGCACGGTAGA	PL-2
TGGCTGGCAGCCTTTC	PL-3
TGGCTGGCAGGATCGA	PL-0
TGGCTGGCATTCTCAT	PL-0
TGGCTGGGTAAAGGAG	PL-0
TGGCTGGGTATTCTCT	PL-0
TGGCTGGGTTAAGTAG	PL-3
TGGCTGGTCACATACG	PL-0
TGGCTGGTCAGAAATG	PL-2
TGGCTGGTCAGGCGAA	PL-0
TGGCTGGTCTCGCATC	PL-Rel
TGGCTGGTCTGCGTAA	PL-AMP
TGGCTGGTCTTTAGTC	PL-vir1
TGGGAAGAGAATTCCC	PL-0
TGGGAAGAGCAACGGT	PL-1
TGGGAAGAGCCACGCT	PL-Inos
TGGGAAGAGGAGCGAG	PL-0
TGGGAAGAGGATGCGT	PL-1
TGGGAAGAGGCCATAG	PL-Rel
TGGGAAGAGGCGACAT	PL-1
TGGGAAGAGTCGCCGT	PL-2
TGGGAAGAGTGTCTCA	PL-0
TGGGAAGAGTGTTGAA	PL-1
TGGGAAGCACCTTGTC	PL-Rel
TGGGAAGCACGCATCG	PL-Inos
TGGGAAGCAGACACTT	PL-2
TGGGAAGCATCCGGGT	PL-Pcd
TGGGAAGCATGGATGG	CC
TGGGAAGGTCACACGC	PL-1
TGGGAAGGTCACTGGC	PL-0
TGGGAAGGTCCTCTTG	PL-2
TGGGAAGGTTACAGAA	PL-1
TGGGAAGGTTATGCGT	PL-2
TGGGAAGTCCAAACTG	PL-Pcd
TGGGAAGTCGGAAACG	PL-3
TGGGAAGTCTCTGAGA	PL-Rel
TGGGCGTAGGATGTAT	PL-Rel
TGGGCGTAGGTACTCT	PL-robo2
TGGGCGTCAAACCCAT	PL-vir1
TGGGCGTCACGGTAAG	PL-1
TGGGCGTCAGCTGTGC	PL-0
TGGGCGTCATCTCGCT	PL-2
TGGGCGTGTCCTCTTG	PL-robo2
TGGGCGTGTCTAAAGA	PL-0
TGGGCGTGTCTCATCC	PL-2
TGGGCGTGTGCTAGCC	PL-vir1
TGGGCGTGTTGTGGAG	PL-2
TGGTTAGAGCGAGAAA	PL-1
TGGTTAGAGCGTCTAT	PL-Rel
TGGTTAGAGGACTGGT	PL-1
TGGTTAGAGGCACATG	PL-0
TGGTTAGAGTCAAGCG	PL-1
TGGTTAGAGTCACGCC	PL-Lsp
TGGTTAGAGTGCAAGC	PL-vir1
TGGTTAGCAAGCTGGA	PL-2
TGGTTAGCACAGCCCA	PL-2
TGGTTAGCACGGATAG	PL-robo2
TGGTTAGCATCACAAC	PL-Inos
TGGTTAGCATCCCACT	PL-2
TGGTTAGGTAGCTCCG	PL-2
TGGTTAGGTCTGCAAT	PL-Rel
TGGTTAGGTGCAACTT	PL-Rel
TGGTTAGGTGCCTTGG	PL-AMP
TGGTTAGGTGCGCTTG	PL-Lsp
TGGTTAGGTGCTAGCC	PL-robo2
TGGTTAGGTTTGACAC	PL-2
TGGTTAGTCATCATTC	PL-1
TGGTTAGTCCGAATGT	PL-2
TGGTTAGTCGAGAACG	PL-robo2
TGGTTAGTCGCGGATC	PL-1
TGGTTCCAGAGCTTCT	PL-0
TGGTTCCAGTACGTAA	PL-Rel
TGGTTCCAGTGTCCCG	PL-robo2
TGGTTCCCAACACCCG	PL-Rel
TGGTTCCCACATTAGC	PL-1
TGGTTCCCACGGCGTT	PL-3
TGGTTCCCAGGCTCAC	PL-Rel
TGGTTCCCATAGGATA	PL-robo2
TGGTTCCGTGACGGTA	PL-3
TGGTTCCGTGAGGGAG	PL-Pcd
TGGTTCCGTTTGACAC	PL-2
TGGTTCCTCTCGTATT	PL-0
TGTATTCAGCTTATCG	PL-0
TGTATTCAGGACAGAA	PL-2
TGTATTCAGTGCTGCC	PL-3
TGTATTCAGTTGCAGG	PL-1
TGTATTCCAAGCCATT	PL-2
TGTATTCCAAGTAGTA	PL-Rel
TGTATTCGTACGCTGC	PL-0
TGTATTCGTATGGTTC	PL-vir1
TGTATTCGTCTCATCC	PL-1
TGTATTCGTGAGGGTT	PL-vir1
TGTATTCGTGTTAAGA	PL-1
TGTATTCGTTAAGTAG	PL-Rel
TGTATTCGTTGCGTTA	PL-1
TGTATTCTCAACACGT	PL-3
TGTATTCTCAGTGTTG	PL-2
TGTATTCTCCTCTAGC	PL-3
TGTATTCTCGGATGGA	PL-2
TGTATTCTCTAAGCCA	PL-0
TGTATTCTCTCGTTTA	PL-1
TGTCCCAAGAAGAAGC	PL-Rel
TGTCCCAAGACGCACA	PL-Rel
TGTCCCAAGCAAATCA	PL-2
TGTCCCAAGGCCATAG	PL-2
TGTCCCACACTGAAGG	PL-0
TGTCCCACATACAGCT	PL-Inos
TGTCCCACATCTCCCA	PL-0
TGTCCCACATTAGGCT	PL-ImpL2
TGTCCCAGTCGAACAG	PL-Pcd
TGTCCCAGTCTCACCT	PL-2
TGTCCCATCCAAGCCG	PL-Lsp
TGTCCCATCCATTCTA	PL-2
TGTGGTAAGCGATAGC	PL-1
TGTGGTAAGTCTCCTC	PL-Lsp
TGTGGTAAGTGTACCT	PL-1
TGTGGTACAAGTACCT	PL-0
TGTGGTACAATCGGTT	PL-3
TGTGGTACACAAGTAA	PL-3
TGTGGTACACTACAGT	PL-0
TGTGGTACAGCCTATA	PL-0
TGTGGTACAGCGAACA	PL-0
TGTGGTACAGGGCATA	PL-1
TGTGGTACATGCCTTC	PL-1
TGTGGTAGTCGACTAT	PL-0
TGTGGTAGTCTAAACC	PL-1
TGTGGTAGTGCACCAC	PL-1
TGTGGTATCACTTACT	PL-1
TGTGGTATCAGATAAG	PL-Rel
TGTGGTATCCAGATCA	PL-vir1
TGTGGTATCGAATGCT	PL-2
TGTGGTATCGTTACAG	PL-0
TGTGTTTAGATGCGAC	PL-0
TGTGTTTAGTCATCCA	PL-2
TGTGTTTCACGAAATA	PL-Rel
TGTGTTTCACGACGAA	PL-1
TGTGTTTCACTAAGTC	PL-0
TGTGTTTCATACCATG	PL-1
TGTGTTTCATGACGGA	PL-0
TGTGTTTCATTCACTT	PL-1
TGTGTTTGTAAGGGAA	PL-Inos
TGTGTTTGTCGCTTCT	CC
TGTGTTTGTGACGGTA	PL-2
TGTGTTTGTGCGGTAA	PL-Rel
TGTGTTTGTGGCCCTA	PL-Rel
TGTGTTTGTGGTGTAG	PL-3
TGTGTTTGTTGTGGCC	PL-0
TGTGTTTTCATCGGAT	PL-0
TGTGTTTTCTACCTGC	PL-1
TGTGTTTTCTTGGGTA	CC
TGTTCCGAGAAGATTC	PL-Rel
TGTTCCGAGACCACGA	PL-3
TGTTCCGAGAGACTAT	PL-1
TGTTCCGAGCCTCGTG	PL-2
TGTTCCGAGTGGAGTC	PL-Rel
TGTTCCGCAAGCCATT	PL-Rel
TGTTCCGCACGGTAAG	PL-vir1
TGTTCCGCACTCTGTC	PL-0
TGTTCCGCAGCTTAAC	PL-2
TGTTCCGGTAAGGATT	PL-0
TGTTCCGGTATTAGCC	PL-robo2
TGTTCCGGTCATATCG	PL-Rel
TGTTCCGGTTAAGTAG	PL-1
TGTTCCGTCAAGGCTT	PL-0
TGTTCCGTCACAATGC	PL-0
TGTTCCGTCAGTCAGT	PL-1
TGTTCCGTCATTGCCC	PL-2
TGTTCCGTCCGATATG	PL-1
TGTTCCGTCGCGATCG	PL-2
TGTTCCGTCGTTACGA	PL-1
TGTTCCGTCTCCGGTT	PL-0
TGTTCCGTCTCGTTTA	PL-1
TTAACTCAGAATTGTG	PL-0
TTAACTCAGACTAGAT	PL-Pcd
TTAACTCAGGTAAACT	PL-Pcd
TTAACTCCAAGGACTG	PL-AMP
TTAACTCCATACCATG	PL-1
TTAACTCCATGCATGT	PL-3
TTAACTCGTAGCGCTC	PL-1
TTAACTCGTGAGTATA	PL-Lsp
TTAACTCGTGTTGAGG	PL-Pcd
TTAACTCTCAGCAACT	PL-0
TTAACTCTCGTTACAG	PL-robo2
TTAACTCTCTGCAGTA	PL-0
TTAACTCTCTGCTGCT	PL-Rel
TTAACTCTCTGCTTGC	PL-2
TTAGGACAGCCATCGC	PL-1
TTAGGACAGCGACGTA	PL-Pcd
TTAGGACAGGCCCTTG	PL-robo2
TTAGGACAGGTAGCTG	PL-0
TTAGGACAGTAACCCT	PL-1
TTAGGACAGTCAATAG	PL-robo2
TTAGGACCAAAGCAAT	PL-0
TTAGGACCAAAGGTGC	PL-vir1
TTAGGACCAGGATTGG	PL-robo2
TTAGGACCAGTAACGG	PL-2
TTAGGACGTGTCAATC	PL-Pcd
TTAGGACTCAAACCGT	PL-1
TTAGGACTCAAGGTAA	PL-2
TTAGGACTCACTTCAT	PL-Rel
TTAGGACTCATCATTC	PL-1
TTAGGACTCCTATGTT	PL-1
TTAGGCAAGACCTTTG	PL-vir1
TTAGGCAAGGTCATCT	PL-0
TTAGGCAAGGTGATAT	PL-1
TTAGGCAAGGTGTGGT	PL-Rel
TTAGGCACAAACTGCT	PL-0
TTAGGCACAGCCACCA	PL-vir1
TTAGGCACATACAGCT	PL-1
TTAGGCACATACTACG	PL-3
TTAGGCAGTCCTCCAT	PL-1
TTAGGCAGTCGCATCG	PL-robo2
TTAGGCAGTCGCGAAA	PL-ImpL2
TTAGGCAGTGATGTCT	PL-2
TTAGGCAGTGTTTGGT	PL-robo2
TTAGGCATCATCTGTT	PL-1
TTAGGCATCCTCAATT	PL-Rel
TTAGGCATCGAGAGCA	PL-0
TTAGGCATCTCCAACC	PL-1
TTAGTTCAGACATAAC	PL-2
TTAGTTCAGCTGATAA	PL-0
TTAGTTCAGGCCATAG	PL-1
TTAGTTCAGTACGATA	PL-1
TTAGTTCAGTACGCGA	PL-1
TTAGTTCAGTCGCCGT	PL-0
TTAGTTCAGTCTCCTC	PL-3
TTAGTTCCACAGCCCA	PL-1
TTAGTTCCAGACAAAT	PL-Rel
TTAGTTCCATATGAGA	PL-1
TTAGTTCCATGGTTGT	PL-Lsp
TTAGTTCGTAGTACCT	PL-0
TTAGTTCGTATCGCAT	PL-2
TTAGTTCGTATGGTTC	PL-Lsp
TTAGTTCGTCCAAGTT	PL-2
TTAGTTCGTGAGGCTA	PL-1
TTAGTTCGTTCATGGT	PL-1
TTAGTTCGTTCGGCAC	PL-1
TTAGTTCTCAAGCCTA	PL-0
TTAGTTCTCGCGTAGC	PL-Pcd
TTAGTTCTCTGTCCGT	PL-robo2
TTATGCTAGTGGGCTA	PL-1
TTATGCTAGTGTCTCA	PL-2
TTATGCTCAATAGAGT	PL-0
TTATGCTCACTCAGGC	PL-robo2
TTATGCTCACTTGGAT	PL-1
TTATGCTCAGCAGTTT	PL-0
TTATGCTGTAAGTAGT	PL-0
TTATGCTGTAAGTGTA	PL-AMP
TTATGCTGTATGGTTC	PL-0
TTATGCTGTCGGGTCT	PL-2
TTATGCTGTTGTGGAG	PL-0
TTATGCTGTTTGGGCC	PL-0
TTATGCTTCACCGTAA	PL-0
TTATGCTTCATAGCAC	PL-0
TTATGCTTCGGCATCG	CC
TTATGCTTCTGCTTGC	PL-0
TTCCCAGAGGTTCCTA	PL-Pcd
TTCCCAGAGTCATGCT	PL-vir1
TTCCCAGCAAGCCCAC	PL-Rel
TTCCCAGCAAGCCGCT	PL-Rel
TTCCCAGCACATGTGT	PL-Rel
TTCCCAGCACCTATCC	PL-robo2
TTCCCAGGTACTCGCG	PL-0
TTCCCAGGTCCGTGAC	PL-1
TTCCCAGGTCGCTTTC	PL-2
TTCCCAGGTGAGGCTA	PL-0
TTCCCAGGTGTGAAAT	PL-robo2
TTCCCAGGTTGTACAC	PL-Rel
TTCCCAGTCCTCAACC	PL-1
TTCCCAGTCCTCCTAG	PL-0
TTCCCAGTCTCTAAGG	PL-0
TTCCCAGTCTGTCCGT	PL-3
TTCCCAGTCTGTTTGT	PL-1
TTCGAAGAGAGAACAG	PL-vir1
TTCGAAGAGTAGGCCA	PL-3
TTCGAAGAGTCTCCTC	PL-1
TTCGAAGAGTGCCATT	PL-1
TTCGAAGCACAACGCC	PL-robo2
TTCGAAGCAGGCGATA	PL-Lsp
TTCGAAGCAGGCTCAC	PL-3
TTCGAAGCAGTCGATT	PL-vir1
TTCGAAGCATAGAAAC	PL-1
TTCGAAGCATATGAGA	PL-3
TTCGAAGCATGGTCTA	PL-robo2
TTCGAAGGTGTTCTTT	PL-0
TTCGAAGGTTATCCGA	PL-1
TTCGAAGTCAGGTTCA	PL-2
TTCGAAGTCGTTTATC	PL-2
TTCGAAGTCTTTAGTC	PL-1
TTCGGTCAGACGACGT	PL-3
TTCGGTCAGACTTTCG	PL-Rel
TTCGGTCAGAGACTTA	PL-2
TTCGGTCAGTGTACGG	PL-Pcd
TTCGGTCCAAGTTCTG	PL-2
TTCGGTCCAGCCTGTG	PL-robo2
TTCGGTCCAGGATTGG	PL-2
TTCGGTCCAGTTTACG	PL-Inos
TTCGGTCCATATACCG	PL-Inos
TTCGGTCCATCGATGT	PL-2
TTCGGTCCATGCTAGT	PL-0
TTCGGTCCATGTCTCC	PL-0
TTCGGTCGTAAGTTCC	PL-1
TTCGGTCGTAGGAGTC	PL-Rel
TTCGGTCGTCAACTGT	PL-1
TTCGGTCGTCTAAAGA	PL-Pcd
TTCGGTCGTTCCAACA	PL-0
TTCGGTCTCAACACAC	PL-2
TTCGGTCTCAGCTCTC	CC
TTCTACAAGAAGGTGA	PL-vir1
TTCTACAAGCAGGCTA	PL-0
TTCTACAAGCGATAGC	PL-2
TTCTACAAGCTGCGAA	PL-2
TTCTACACAGATCTGT	PL-1
TTCTACACATCCTTGC	PL-Inos
TTCTACAGTTCAGGCC	PL-1
TTCTACATCAGAGCTT	PL-Rel
TTCTACATCCTTCAAT	PL-2
TTCTACATCGCCCTTA	PL-Inos
TTCTACATCGGATGGA	PL-Rel
TTCTACATCTGCGGCA	PL-robo2
TTCTCAAAGCAGGCTA	PL-3
TTCTCAAAGCTGCCCA	PL-2
TTCTCAAAGCTGTCTA	PL-Inos
TTCTCAAAGGGATGGG	PL-robo2
TTCTCAAAGTCATCCA	PL-0
TTCTCAACAAAGTGCG	PL-3
TTCTCAACAAGGACTG	PL-0
TTCTCAACAAGGCTCC	PL-Rel
TTCTCAACAAGTTGTC	PL-3
TTCTCAAGTGTAATGA	PL-2
TTCTCAATCCTCAATT	PL-2
TTCTCAATCGCCATAA	PL-2
TTCTCAATCGTATCAG	PL-1
TTCTCCTAGAAGGGTA	PL-2
TTCTCCTAGACAGAGA	PL-0
TTCTCCTAGATTACCC	PL-vir1
TTCTCCTAGCAGACTG	PL-0
TTCTCCTAGCGTAGTG	PL-Inos
TTCTCCTAGTGCCATT	PL-2
TTCTCCTCAACACGCC	PL-Rel
TTCTCCTCAATCTGCA	PL-Rel
TTCTCCTCAATGGAAT	PL-robo2
TTCTCCTCAGCATACT	PL-1
TTCTCCTCAGTCAGCC	PL-Pcd
TTCTCCTCATCGGACC	PL-1
TTCTCCTCATGAAGTA	PL-0
TTCTCCTGTACCATCA	PL-Inos
TTCTCCTGTAGCGTAG	PL-2
TTCTCCTGTCAGAGGT	PL-2
TTCTCCTGTCCCTTGT	PL-Pcd
TTCTCCTGTCCTCCAT	PL-2
TTCTCCTGTCTAGCGC	PL-robo2
TTCTCCTGTTATGCGT	PL-1
TTCTCCTTCTCGTATT	PL-2
TTCTCCTTCTTAGAGC	PL-1
TTCTTAGAGCAATCTC	PL-3
TTCTTAGAGGACAGAA	PL-1
TTCTTAGCAATAGCAA	PL-1
TTCTTAGCAATCTACG	PL-3
TTCTTAGCACGACTCG	PL-vir1
TTCTTAGCACTTCGAA	PL-Rel
TTCTTAGCATGAACCT	PL-Rel
TTCTTAGGTCTAGCCG	PL-vir1
TTCTTAGGTCTTCTCG	PL-3
TTCTTAGGTTCGCGAC	PL-Rel
TTCTTAGTCAGGCAAG	PL-3
TTGAACGAGAAACCAT	PL-3
TTGAACGAGGAGCGAG	PL-0
TTGAACGAGGGCACTA	PL-robo2
TTGAACGCAACTGCTA	PL-1
TTGAACGCACATGGGA	PL-1
TTGAACGGTAACGTTC	PL-Inos
TTGAACGGTTCACGGC	PL-1
TTGAACGTCCCATTTA	PL-2
TTGAACGTCGCCGTGA	PL-0
TTGAACGTCTTTAGGG	PL-2
TTGACTTAGTACGTAA	PL-2
TTGACTTCATAGAAAC	PL-1
TTGACTTCATATACGC	PL-robo2
TTGACTTGTAAGGGAA	PL-robo2
TTGACTTGTAAGTGTA	PL-Inos
TTGACTTGTACTCGCG	PL-3
TTGACTTGTAGGGTAC	PL-1
TTGACTTGTTACGACT	PL-2
TTGACTTGTTGTACAC	PL-2
TTGACTTGTTTGGGCC	PL-Rel
TTGACTTTCACCAGGC	PL-2
TTGACTTTCATGTCCC	PL-0
TTGACTTTCATGTCTT	PL-1
TTGACTTTCTGCAAGT	PL-Inos
TTGCCGTAGACACGAC	PL-1
TTGCCGTAGCAGGTCA	PL-Rel
TTGCCGTAGCTGAACG	PL-0
TTGCCGTAGGACAGAA	PL-Pcd
TTGCCGTAGGCAGTCA	PL-AMP
TTGCCGTAGTACGACG	PL-Rel
TTGCCGTAGTACGCCC	PL-2
TTGCCGTCAAGTCTGT	PL-3
TTGCCGTCACACTGCG	PL-2
TTGCCGTCAGTATGCT	PL-0
TTGCCGTGTCGACTGC	PL-1
TTGCCGTGTTCGGGCT	PL-1
TTGCCGTTCCCTAACC	PL-1
TTGCCGTTCTGCTGCT	PL-2
TTGCCGTTCTTGAGAC	PL-Lsp
TTGCGTCAGCAATATG	PL-3
TTGCGTCAGCGCTCCA	PL-Pcd
TTGCGTCAGTATGACA	PL-2
TTGCGTCCAAACAACA	PL-Lsp
TTGCGTCCAATCAGAA	PL-1
TTGCGTCCACCTCGTT	PL-Rel
TTGCGTCCATCGATTG	PL-vir1
TTGCGTCGTACGACCC	PL-2
TTGCGTCTCCTCAATT	PL-1
TTGGAACAGCCCAATT	PL-1
TTGGAACAGGACAGCT	PL-1
TTGGAACAGGAGTTTA	PL-0
TTGGAACCAAAGCAAT	PL-2
TTGGAACCAAGAGGCT	PL-robo2
TTGGAACCAAGTTCTG	PL-0
TTGGAACCAATAGAGT	PL-3
TTGGAACCAATGGACG	PL-3
TTGGAACCAGGATCGA	PL-2
TTGGAACCAGGGTATG	PL-Pcd
TTGGAACCATATGGTC	PL-2
TTGGAACGTAAGTGGC	PL-Rel
TTGGAACGTGCTGTAT	PL-2
TTGGAACGTGTCGCTG	PL-2
TTGGAACGTGTGACCC	PL-Rel
TTGGAACGTTCACCTC	PL-1
TTGGAACGTTCATGGT	PL-Inos
TTGGAACGTTTCGCTC	PL-Inos
TTGGAACTCATAGCAC	PL-0
TTGGAACTCATGTGGT	PL-0
TTGGAACTCCACGTGG	PL-1
TTGGAACTCCCTCAGT	PL-Pcd
TTGGAACTCGGCGCAT	PL-2
TTGGAACTCGGCTACG	PL-Rel
TTGGAACTCTATCGCC	PL-1
TTGGCAAAGCGTGTCC	PL-Inos
TTGGCAAAGCTTTGGT	PL-2
TTGGCAAAGTACGCCC	PL-0
TTGGCAAAGTCAAGGC	PL-Inos
TTGGCAACACTATCTT	PL-vir1
TTGGCAACAGCCAATT	PL-3
TTGGCAACAGCCACCA	PL-3
TTGGCAACAGCGTCCA	PL-Rel
TTGGCAACATCGTCGG	PL-vir1
TTGGCAAGTAGCACGA	PL-0
TTGGCAAGTCCGCTGA	PL-Rel
TTGGCAAGTCTCTTTA	PL-2
TTGGCAAGTTACAGAA	PL-1
TTGGCAAGTTCCTCCA	PL-vir1
TTGGCAATCACCCTCA	PL-2
TTGGCAATCCCATTAT	PL-1
TTGGCAATCCGAATGT	PL-0
TTGGCAATCGGTCCGA	PL-1
TTGGCAATCTAACTCT	PL-vir1
TTGTAGGAGACGCAAC	PL-Pcd
TTGTAGGAGACGCTTT	PL-prolif
TTGTAGGAGAGGTACC	PL-Rel
TTGTAGGAGTGCAAGC	PL-1
TTGTAGGCAACACCCG	PL-0
TTGTAGGCAAGAGGCT	PL-1
TTGTAGGCAGGGTATG	PL-0
TTGTAGGCATATACCG	PL-2
TTGTAGGCATTGTGCA	PL-2
TTGTAGGGTCGAGTTT	PL-Rel
TTGTAGGGTCTAGAGG	PL-robo2
TTGTAGGGTCTCTTAT	PL-Pcd
TTGTAGGGTCTGATCA	PL-0
TTGTAGGGTGCACCAC	PL-2
TTGTAGGTCAATAAGG	PL-0
TTGTAGGTCCAGGGCT	PL-2
TTGTAGGTCGACCAGC	PL-Rel
TTGTAGGTCTTGTCAT	PL-0
TTTACTGAGCTAGGCA	PL-vir1
TTTACTGAGGATCGCA	PL-robo2
TTTACTGAGGGAACGG	PL-0
TTTACTGAGGTGACCA	PL-1
TTTACTGCAATTCCTT	PL-Rel
TTTACTGCACAACGTT	PL-1
TTTACTGCACGAGGTA	PL-vir1
TTTACTGCATACTCTT	PL-2
TTTACTGGTAAACCTC	PL-0
TTTACTGGTAATTGGA	PL-Inos
TTTACTGGTCAATACC	PL-3
TTTACTGGTCCAAGTT	PL-2
TTTACTGGTCCTGCTT	PL-1
TTTACTGTCAAACCAC	PL-vir1
TTTACTGTCCACGTGG	PL-1
TTTATGCAGAATTGTG	PL-0
TTTATGCAGACTTTCG	PL-3
TTTATGCAGAGTCGGT	PL-1
TTTATGCAGGACACCA	PL-Rel
TTTATGCAGGAGTAGA	PL-3
TTTATGCAGGGTATCG	PL-Lsp
TTTATGCAGTAATCCC	PL-3
TTTATGCCAACTGCTA	PL-0
TTTATGCCACTTGGAT	PL-3
TTTATGCCAGACGCAA	PL-3
TTTATGCCAGGGCATA	PL-1
TTTATGCCAGTTAACC	PL-Rel
TTTATGCCATGTAAGA	PL-1
TTTATGCGTACAGTTC	PL-Rel
TTTATGCGTAGAAAGG	PL-0
TTTATGCGTAGCAAAT	PL-Rel
TTTATGCGTAGCCTAT	PL-3
TTTATGCGTTGGTAAA	PL-Rel
TTTATGCGTTTAGCTG	PL-2
TTTATGCTCGCTTGTC	PL-Rel
TTTCCTCAGTGCGATG	PL-Rel
TTTCCTCCAAACGCGA	PL-0
TTTCCTCCAATCCAAC	PL-Lsp
TTTCCTCCAGCTGCTG	PL-0
TTTCCTCGTAGATTAG	PL-2
TTTCCTCGTCAGTGGA	PL-Inos
TTTCCTCGTCGAGTTT	PL-3
TTTCCTCGTCGCATAT	PL-0
TTTCCTCGTCTTCGTC	PL-3
TTTCCTCGTTAAGAAC	PL-robo2
TTTCCTCGTTTGACAC	PL-2
TTTCCTCTCCAGTAGT	PL-Rel
TTTCCTCTCGTGGGAA	PL-1
TTTCCTCTCTGCCCTA	PL-Rel
TTTGCGCAGAAGGCCT	PL-Inos
TTTGCGCAGAAGGGTA	PL-1
TTTGCGCAGGAGCGTT	PL-Pcd
TTTGCGCAGGGAACGG	PL-2
TTTGCGCAGTTGTAGA	PL-vir1
TTTGCGCCAATCTGCA	PL-2
TTTGCGCCAGTCAGAG	PL-3
TTTGCGCCATACTACG	PL-2
TTTGCGCCATATGGTC	PL-2
TTTGCGCCATCTCCCA	PL-Rel
TTTGCGCGTAGCGCTC	PL-0
TTTGCGCGTCAAAGAT	PL-1
TTTGCGCTCAGTGCAT	PL-0
TTTGCGCTCCCATTAT	PL-2
TTTGCGCTCCTCGCAT	PL-0
TTTGCGCTCCTTGACC	PL-1
TTTGCGCTCTCTGAGA	PL-Rel
TTTGGTTAGCTGTCTA	PL-3
TTTGGTTAGGTGACCA	PL-2
TTTGGTTAGTCAAGCG	PL-0
TTTGGTTAGTGCAAGC	PL-2
TTTGGTTCACAGGTTT	PL-Inos
TTTGGTTCACCAGGTC	PL-vir1
TTTGGTTCAGACAGGT	CC
TTTGGTTCAGTATGCT	PL-1
TTTGGTTCATTTGCCC	PL-Pcd
TTTGGTTGTAGCCTCG	PL-1
TTTGGTTGTAGGCTGA	PL-2
TTTGGTTGTCGCGGTT	PL-Rel
TTTGGTTGTGATGTCT	PL-0
TTTGGTTTCACGGTTA	PL-robo2
TTTGGTTTCAGTCAGT	PL-0
TTTGGTTTCCCTGACT	PL-1
TTTGGTTTCTCGATGA	PL-Rel
TTTGTCAAGACGCTTT	PL-vir1
TTTGTCAAGAGCTTCT	PL-vir1
TTTGTCAAGCCTATGT	PL-Rel
TTTGTCAAGGACATTA	PL-3
TTTGTCAAGGCTCATT	PL-Rel
TTTGTCAAGTACGCGA	PL-0
TTTGTCAAGTAGATGT	PL-Rel
TTTGTCACAATTCCTT	PL-3
TTTGTCACACAGGCCT	PL-robo2
TTTGTCACATCTATGG	PL-1
TTTGTCACATGTAGTC	PL-0
TTTGTCAGTCTCTTTA	PL-1
TTTGTCAGTGGTAACG	PL-3
TTTGTCAGTGGTGTAG	PL-0
TTTGTCAGTTGGTTTG	PL-Rel
TTTGTCATCAGCTTAG	PL-Rel
TTTGTCATCCTTCAAT	PL-Rel
TTTGTCATCGCTTGTC	PL-3
TTTGTCATCGTATCAG	PL-2
